-----------------------------------------------------------------------------------------SSS----%%%%%%%%----------------------------------------------
----------------------SS------------------------------------------------------------------------------------------------------------------------------
-------------------------------------------------------------------------------------##-------------------------------------------SSSS!------2--------
-----------------------------------------------------------------------------------y###--------------------------------------------------------K------
-------------------------------------------------------------------------------QQ?SSSSSSS-------------------------------------------------------------
----------------SS------------------------------------------------------------------------------------------------------------------------------------
----------------------------------------------------------------------------------------TT--!---------------------------------------------------------
------------------------------------------------------------------------------K---------TT------------------------------------------------------------
---------------------------------------------------------TT--------------SSSSSSSSSS-----TT----------------------------------------------------------k#
------------------------------------------------1--------TT-----------------------------TT---------------------------------------------------------F##
---------------------------------------------------------TT----------SSS------------XXXXXXXXXXXXXX---------------------------------y---------------###
------TT----------TT-------------------------------------TT------------------------XXXXXXXXXXXXXXX-------------SSSSSSSSSSSSSSSSSSSSS--------------####
----#-TT----------TT--------B------tt-TT-----------------TT----g-##---------------XXXXXXXXXXXXXXXX-------------------#---------------------------#####
----M-TT----------TT----y---b------tt-TT--y-y-------ggg--TT---g#-##---#----------XXXXXXXXXXXXXXXXX-------------------#--y---------gg---------ggg######
XXXXX-XXXXXXXXXXXXXXXXXXXXXXXXXXXXXXXXXXXXXXXXXXXXXXXXXXXXX-XXXXXXXXXXXXXXXXXXXXXXXXXXXXXXXXXXXXX--XXXXXXXXXXXXXXXXXXXXXXXXXXXXXXXXXXXXXXXXXXXXXXXXXXX
XXXXX-XXXXXXXXXXXXXXXXXXXXXXXXXXXXXXXXXXXXXXXXXXXXXXXXXXXXX-XXXXXXXXXXXXXXXXXXXXXXXXXXXXXXXXXXXXX--XXXXXXXXXXXXXXXXXXXXXXXXXXXXXXXXXXXXXXXXXXXXXXXXXXX