------------------TT---------TT-----------------------------------------------------------------------------------------------------------------------
------------------TT---------TT-----------------------------------------------------------------------------------------------------------------------
------------------XXS--------XX-------------------------------SSSSSSSS---------------------SSSSS--------SS--------------------------------------S-----
--------------------------------------------------------------SSSSSSSS--------------SSS-----------------SS--------------------------------------------
--------------------------------------------------------------------------------------------------------SS!S-------------------------------------USS--
------------------------------------------------------------------------------------------------------------------------------------------------------
---------SSSS-----------------------------------------------------------------------------------------------------------------------------------------
------------------------------------------------------------------------SSSSSSSS----------------------------------------------------------TT----------
---------------------------##----%%%%--%%%---------------------------------@--------------------------------------------------------------TT----------
--------------------------###-------------------------------------------------------------------------------------------------------------TT----------
-------------------------####-------------##----------------------------------------------------------------------------------------------TT----------
------------------------#####-------------##----------------------------------------------------------------------------------------------TT----------
---------------tt------######-------------###-----------##-------TT--------------------------------------TT------------------SSS----------TT----------
---------------tt-----#######-------------####-------#####-------TT--------------------------------------TT-------------------------------TT----------
XXXXXXXXXXXXXXXXXXXXXXXXXXXXXXXXXXXXXXXXXXXXXXXXXXXXXXXXXXXXXXXXXXXXXX--%%%%%%%%------------------XXXXXXXX----------------------XXXXXXXXXXXXXXXXXXXXX-
XXXXXXXXXXXXXXXXXXXXXXXXXXXXXXXXXXXXXXXXXXXXXXXXXXXXXXXXXXXXXXXXXXXXXX----------------------------XXXXXXXX----------------------XXXXXXXXXXXXXXXXXXXXX-