-------------SUSSS------------------------------------------------------------------------------------------###---------------------------------------
------------------------------------------------------------------------------------------------------------###---------------------------------------
------------------------------------------------------------------------------------------------------------####--------------------------------------
------------------------------------------------------------------------------------------------------------##----------------------------------------
------------------------------------------------------------------------------------------------------------------------------------------------------
------------------------------------------------------------------------------------------------------------------------------------------------------
-----1--------------------------------------------------------------------------------------------------------------US--------------------------------
-----------------------------------SSSSS---------------------------C----------------------------------------------------------------------------------
--------------------------------------------SU-----------------------------Q-Q-Q----------------------------------------------------------------------
-----------------------------------------------------------------#------------------------------------------------------------------------------------
-----------------###-------------------------------TT----tt-----##------------------------------------------------------------------------------------
---------TT-----##----------TT---------------------TT----tt----###------------------------------------------------------------------------TT-------F--
---------TT----###----------TT-----------TT--------TT----tt-####----TT----------------------------------------tt--------------------------TT-------TT-
---gMg--kTT---####---#------TT-----------TT--------TT--g-tt######---TT----------------kkk---------------------tt-----------------kkkk-----TT-------TT-
XXXXXXXXXXXXXXXXXXXXXXXXXXXXXX-XXXXXXXXXXXXXXXXXXXXXXXXXXXXXXXXXXXXXXXXXXXXXXXXXXXXXXXXXXXXXX-XXXXXXXXXXXXXXXXXXXXXXXXXXXXXXXXXXXXXXXX----XXXXXXXXXXXX
XXXXXXXXXXXXXXXXXXXXXXXXXXXXXX-XXXXXXXXXXXXXXXXXXXXXXXXXXXXXXXXXXXXXXXXXXXXXXXXXXXXXXXXXXXXXX-XXXXXXXXXXXXXXXXXXXXXXXXXXXXXXXXXXXXXXXX----XXXXXXXXXXXX