--------SS-------------------------------------------------------------------------------------%%%%----@--------------------!-------------------------
---ggg--SS--------------------------------------------------------------------------------------------------------------------------------------------
--SSSSSS----------------------------------------------------------------------------------------------------------------------SSSSSSSSSSSS------------
--SSSSSS-------------------------------R-----------------------------------------SSSSS----------------------------------------SSSSSSSSSSSS------------
--SSSSSS----------------------------------------------------------------QQ----------------------------------------------------SSSSSSSSSSSS------------
--SSSSSS-------SSSSSSSS--------------------------------------------------------g----------------------------------------------SSSSS-------------------
------------------------####--------------SSSS?SSSSSS-------------------------SS----------------------------------------------SSSSS-------------------
------------------------##----------------------------------------------------SS----------------------------------------------------------------------
----------------------------------------------------------------------------SSSS----------------------------------------------------------------------
------------------------------------------------------------------------------------------------------------------------------------------U-----------
----------------------------------TTSU-------------------------------------------------%%%------------TT-----------------TT---------------------------
--------------------------------TTTT---------------------TT---------------------------------------#-TTTT-----#-----------TT---------------------------
--------------------------------TTTT---*-----tt----------TT------tt-TTTT--------------------------#-TTTT----##-----------TT-------------------B------#
----M-------k-------------kk---kTTTT---*-----tt----------TT------tt-TTTT---------%%%%-------------#-TTTT---###-----gggg--TT-------------------b----F##
XXXXXXXXXXXXXX-----XXXXXXXXXXXXXXXXXXXXXXXXXXXXXXXXXXXXXXXXXXXXXXXXXXXXXXXXXXXX---X-XXXX-XXXXXXXXXX-XXXXXXXXXXXXXXXXXXXXXXXXXXXXXXXXXXXXXXXXXXXXXXXXXX
XXXXXXXXXXXXXX-----XXXXXXXXXXXXXXXXXXXXXXXXXXXXXXXXXXXXXXXXXXXXXXXXXXXXXXXXXXXX---X-XXXX-XXXXXXXXXX-XXXXXXXXXXXXXXXXXXXXXXXXXXXXXXXXXXXXXXXXXXXXXXXXXX