---%%%%------------SS#CSSS--------------------------------------------SCS-----------------------------------------------------------------------------
------------------------------------------------------------------------------------------------------------------------------------------------------
--------------------------------------------------------------------------------------------------------------------------------------------SS!S------
S---------------------------------------------------------------------------SS-?----------------------------------------------------------------------
S-----------------------------------------------------------------------------------------------------------------------------------------------------
S-----------------------------------------------------------------------------------------------------------------------------------------------------
S--------------------------------####--------------------------------------%%%%----------1------------------------------------------------------------
S-------------------------------##------------------------------------------------------------------------------------------------------SSSSSSSSSSSSSS
S------------------------------###--SSSSS--------------------------------------------------------------------------##---------------------#LSSS-------
S-----------------------------####---------------------#----------------------------------------------------------###---------------------#-----------
S-----------TT---------------#####--------------------##--------------------TT-----------------------------------####---------------------#-----------
S-----------TT--------------######-------------------###--------------------TT----------------------------------#####---------------------#-----------
S-----------TT----#-TT-----#####--------------------##----------------------TT--------*----B-------------------######----------TT---------#-----------
S-----------TT----#-TT----#######------------------####-----#---------------TT--------*----b------------------#######----------TT---------#-----------
XXXXXXXXXXXXXXXXXXX-XXXXXXXXXXXXXXXXXXXXXXXXXXXXXXXXXXXXXXXXXXXXXXXXXXXXXXXXXXXXXXXXXXXXXXXXX-------------XXXXXXXXXXX--X-XXXXXXXXXXXXXX-XXXXXXXXXXXXXX
XXXXXXXXXXXXXXXXXXX-XXXXXXXXXXXXXXXXXXXXXXXXXXXXXXXXXXXXXXXXXXXXXXXXXXXXXXXXXXXXXXXXXXXXXXXXX-------------XXXXXXXXXXX--X-XXXXXXXXXXXXXX-XXXXXXXXXXXXXX