------------------------------------------------------------------------------------------------------------------------------------------------------
------------------------------------------------------------------------------------------------------------------------------------------------------
------------------------------------------------------------------------------------------------------------------------------------------------------
S-----SSSSSSSSSSSSSSSSSSSSSSSSSSSSSSSSSSSSSSSSSSSSSSSSSSSSSSSSSSSSSSSSSSSSSSSSSSSSSSSSSSSLSSSSSSSSSSSSSSSSSSSSSSSSSSSSSSSSSSSSSSSSSSSSSSSSSSSSSSSSS---
S-----------------------------------------------------SS--SSSSSS--SSSS------SSSS-----------------------------------------------------------------SS---
S-----------------------------------------------------SS--SSSSSS--SSSS---g--SSSS-----------------------------------------------------------------SS---
S---------------------------------------------------SS--------SS---S----SS---------------------------------------------------------------------SS-----
S---------------------------------------------------SS--------SS---S----SS---------------------------------------------------------------------SS-----
S--------------------------------------S-SSSS-U-----SS--------SS---S----SS----------SSSSSS----------------------------------------S-SSSS-U-----SS-----
S----------------------------C---------S-S--S-S-----SS--------SS---S-U--SC--g-g-----SSSSSS----------------------------k-------------------------------
S---------@QQQQ--------#-#-------------SSS--SSS-----SSSS--SSSSSS---SSS--SS--SSSS-----------------------------TT-----?QQQQ----------S-----TT---QQQQ----
S--------------------#-#-#-#---#----------------------SS-----------------------------------------------TT----TT--------------------------TT-----------
S----------------g-#-#-#-#-#---#-#--------------------SS-----------------------------------------------TT----TT--------------------------TT-----------
S---------------g#-#-#-#-#-#-E-#-#--------kk----------------k--g-g------------------------------g-g-g--TT----TT------------gg----k-ggg---TT-------F---
XXXXXXXXXXXXXXXXXXXXXXXXXXXXXXXXXXXXXXXXXXXXXXXXXXXXXXXXXXXXXXXXXXXXXXXXXXXXXXXX---XXXXXXXXXXXXXXXXXXXXXXXXXXXXXXXXXXXXXXXXXXXXXXXXXXXXXXXXXXXXXXXX---
XXXXXXXXXXXXXXXXXXXXXXXXXXXXXXXXXXXXXXXXXXXXXXXXXXXXXXXXXXXXXXXXXXXXXXXXXXXXXXXX---XXXXXXXXXXXXXXXXXXXXXXXXXXXXXXXXXXXXXXXXXXXXXXXXXXXXXXXXXXXXXXXX---