-------------------2----------------------------TT-----------------------------%%%%-------------------------------------------------------------------
---------------------K--------------------------TT----------------------------------------------------------------------------------------------------
-----------------------------------------------SXXS---------------------------------------------------------------------------------------------------
------------------------------------------------------------------------------------------------------------------------------------------------------
---------------------------------####------------------------------------------------------------------------------------------?----------------------
-------------------------------y##--------------------------------------------------------------------------------------------------------------------
-------------------------------###--------------------------------------------------------------------------------------------------------------------
----SSSS----------------------####-----TT-------------------%%----------------------------------------------------------------------------------------
-----------------y-----------#####-----TT----------------------------------------------------------------------------------------------TT-------------
-----------------XSSSS--kk--######-----TT----K-----------------------------------------------------------------------------------------TT-------------
----------------XXXXXXXXXXXXXXXXXXXXXXXXXXXXXX------------------------------------------------%%%%%-%%%------S------------SS-----------TT-------------
---------------XXXXXXXXXXXXXXXXXXXXXXXXXXXXXXX----------------------------------------------------------------------------SS-----------TT----------%%%
---K-B--------XXXXXXXXXXXXXXXXXXXXXXXXXXXXXXXX--------TT--------------------#-----*-------TT---------K#-------------------SS-----------TT-----TT------
----Mb-------XXXXXXXXXXXXXXXXXXXXXXXXXXXXXXXXX--------TT------k---kk----kkk-#-----*-------TT----------#----g-ggg----------SS------ggg--TT---k-TT---F--
XXXXXXXXXXXXXXXXXXXXXXXXXXXXXXXXXXXXXXXXXXXXXXX--XXXXXXXXXXXXXXXXXXXXXXXXXXXXXXXXXXXXXXXXXXXXXXXXXXXXXXXXXXXXXXXXXX----XXXXXXXXXXXXXXXXXXXXXXXXXXXXXXX
XXXXXXXXXXXXXXXXXXXXXXXXXXXXXXXXXXXXXXXXXXXXXXX--XXXXXXXXXXXXXXXXXXXXXXXXXXXXXXXXXXXXXXXXXXXXXXXXXXXXXXXXXXXXXXXXXX----XXXXXXXXXXXXXXXXXXXXXXXXXXXXXXX