--------------------------------------------SQS-----------CSS-----------------------------------------------------------SS----------------------------
------------------------------------------------------K-----------------------------------------------------------------------------------------------
----------------------------------------------------SSSS--2-------------------------------------------------------------------------------------------
S--------------------------------------------------------2-2----------------------------SSSSSS-?Q-----------------------SSSSSSSSSSSSSSSSSSSS----------
S---------------------------%%%%---------------#------------------------------------------%%-----USS--------------------------------------------------
S---------------------------------------------##------------------------------------------------------------------------------------------------------
S--------------------------------------------###----------------------------------------------------QQ--------------------------SSSSS-----------------
S------SSSSSSSSS---------%%%----------------####-------------------------K-----------------------------K-----tt---------------------------------------
S-------------------------------------------####---------------------------------------------------------TT--tt---------!--!--------------------------
S-----------------------------------------#-####---------------------------------------------------------TT--tt---------------------------------------
S-----------------------#----------------##---------------------------!--!-----------------SS---######---TT--tt--------------#----------------!-------
S-----------------------#---TT----------###--SSSSSSSSSSSSSSS------------------------------------#--------TT--tt---------k----##-----------------------
S--------*--------------#---TT---------####----------------------------------------------------K#--------TT--tt--------##--####--------------------F--
S---M----*--------------#--kTT-----y--#####-----------k----ggg--------k------------------k-g----#--k----gTT--tt-------###--#####--#----gggg-------kk--
XXXXXXXXXXXXXXXXX---XXXXXXXXXX-XXXXXXXXXXXXXXXXXXXXXXXXXXXXXXXXXXXXXXXXXXXX---XX-----XXXXXXXXXXXXXXXXXXXXXXXXXXXXXXXXXXXX--XXXXXXXXXXXXXXXXXXXXXXXXXXX
XXXXXXXXXXXXXXXXX---XXXXXXXXXX-XXXXXXXXXXXXXXXXXXXXXXXXXXXXXXXXXXXXXXXXXXXX---XX-----XXXXXXXXXXXXXXXXXXXXXXXXXXXXXXXXXXXX--XXXXXXXXXXXXXXXXXXXXXXXXXXX