-------------SSSS---------------------------------------------------------------%%%-------------------------------------------------------------------
------------------------------------------------------------------------------------------------------------------------------------------------------
--------------------------------------------------------------------------------------------------------%%%%%--%%%%%%---------------------------------
S----------------------------------------------------------------------------------------------SSSS---------------------------------------------------
S---------------------------------------------------------------%%%%%%%%%----------------------------------------------------SSSSS--------------------
S-----------------------------------------------------------------------------------------------------------------------------------------------------
S----------------------SCSS--------------------------------------------tt--------------------------------------------------------------%%%%%----------
S----SSSSSSSS----------------------------------------------------------tt----------------------------------------#------------------------------------
S----------------------------------------------------------------------tt-TT----------------------SS--SCSS------##-------------------------------SSSSS
S----------%%%%%%%%%%%%%%------------------------------SSSSSSSSSSSS----tt-TT----------------------SS-----------###------------------------------------
S-------------------------------------------------------------XXXXXXXXXXXXXXXX--------------------SS---SXX----####------------%%%%%----------SSS------
S------------------------------------C--------------TT-------XXXXXXXXXXXXXXXXX-----TT------------------------#####------------------------------------
S--------tt---------------------------------------TTTT------XXXXXXXXXXXXXXXXXX-----TT---------------------########------------------------------------
S--------tt------------------------#--------------TTTT-----XXXXXXXXXXXXXXXXXXX-----TT--------------------#########------------------------------------
XXXXXXXXXXXXXX---X-XXXXXXXXXXXXXXXXX----------XXXXXXXXXXXXXXXXXXXXXXXXXXXXXXXX-XXXXXXXXXXXXXXXXXXXXXXXXXXXXXXXXX----------%%--------------------------
XXXXXXXXXXXXXX---X-XXXXXXXXXXXXXXXXX----------XXXXXXXXXXXXXXXXXXXXXXXXXXXXXXXX-XXXXXXXXXXXXXXXXXXXXXXXXXXXXXXXXX--------------------------------------