---------------------------------------------SUSSSSSSSSSSS--------------------------------------------------------------------------------------------
------------------------------------------------------------------------------------------------------------------------------------------------------
----------------------SSS----------------------------------------------------------2----------------------SS------------------------------------------
-------------------------------------------------------------------------------------K----------------------------------------------------------------
----------------------------------------------------------------US----------------------USS-----------------------------------------------------------
------------------------------------------------------------------------------------------------------------------------------------------------------
------------------------------------------------------------------------------------------------------------------------------------------------------
------------------------------------------------------------------------------------------------------------------------------------------------------
--------------------------------------------------------------------------------------------------------------------------SSS-------------------------
------------------------------------------------------------------------------------------------------------------------------------------------------
--------#######------------------------------TT--------------##----------------------------------------------------------------2-----1----------------
--------#-----------------------#------------TT--------------##--------------------------------------------R--------SS-----------K------------------tt
-------K#------------------TT---#------------TT------------###--TT-------#--------------TT----TTTT---------------b----------------------------------tt
----M---#-----------gg-----TT---#------------TT----k----kk-###--TT-------#--------gg----TT----TTTT---k-----------b-------------------g-gggg--------Ftt
XXXXXXXXXXXXXXX--XXXXXXXXXXXXXXXXXXXXXXXXXXXXXXXXXXXXXXXXXXXXXXXXXXXXXXXXXXXXXX-XXXXXXXXXXXXXXXXXXXXXXXXX-----XXXXXXXXXXXXXXXXXXXXXXXXXXXXXXXXXX--XXXX
XXXXXXXXXXXXXXX--XXXXXXXXXXXXXXXXXXXXXXXXXXXXXXXXXXXXXXXXXXXXXXXXXXXXXXXXXXXXXX-XXXXXXXXXXXXXXXXXXXXXXXXX-----XXXXXXXXXXXXXXXXXXXXXXXXXXXXXXXXXX--XXXX