------------------------------------------------------------------------------------------------------------------------------------------------------
------------------------------------------------------------------------------------------------------------------------------------------------------
------------------------------------------------------------------------------------------------------------------------------------------------------
S-----------------------------------------------------------------------------------------------------------------------------------------------------
S------------------------------%%%%-------------------------------------------------------------------------------------------------------------------
S-----------------------------------------------------------------------------------------------------------------------------------------------------
S----------------------------------------SSSS-------------##------------------------------------------S-----------------------------------------------
S---------------------------------------------------------##---ggg---g--------------------------------------------------------------------------------
S---------------------------------------------------------############----------------------------------#----------------------------------%%%--------
S---------------------------------------------------------##--------------------------------------------#--------------------------------------------y
S---------------------------------------------------------------TT--------------------------------------#-----------------------TTSUS----------------#
S--------------------------------TT---------------------------TTTT-------------------------------------##-----------------------TT----%%%----------F##
S------------TT-------TT---------TT-------------------------TTTTTT------------------------------------###---#-------------------TT--------*--------###
S---M----#---TT-------TT-------k-TT--------------------y----TTTTTT------------------g----------------####---#-----k---------ggg-TT--------*-------####
XXXXXXXXXXXXXXXXXXXXXXXXXXXXXXXXXXXXXXXXXXXXXXXXXXXXXXXXXXXXXXXXXXXXXXXXXXXXXXXXXXXXXXXXXXXXXXXXXXXXXXXXXXXXXXXXXXXXXXXXXXXXXXXXXXXXXXXXXXXXXXXXXXXXXX
XXXXXXXXXXXXXXXXXXXXXXXXXXXXXXXXXXXXXXXXXXXXXXXXXXXXXXXXXXXXXXXXXXXXXXXXXXXXXXXXXXXXXXXXXXXXXXXXXXXXXXXXXXXXXXXXXXXXXXXXXXXXXXXXXXXXXXXXXXXXXXXXXXXXXX