---------------------------------------------------------------------------------------------------------------------------SSS------------------------
--------------------------------------------------SSSSSSSSS-----------------------------------------------Q--?Q---------------------------------------
-------------------------------------------%%%%%--SSSSSSSSSSSSSSSS---------------------------@--------------------------------------------------------
-----------------------------SSSSSSSSSSSSS--------SSSSSSS---------------------------------------------------------------------------------------------
-----------------------------------------------#SSSSSSSSS---------------------------------------------------------------------------------------------
----------------------------------------------##------------------------------------------------------------------------------------------------------
-----SSSSSS---r-r-r-------------------------k###------------------------------------------------------------------------------------------------------
------------%%%%%%%%%%%%--------------------####------------------------------------------------------------------------------------------------------
-------------------------------------------###---------------------------------------------------------------###--------------------------------------
------------------------------------------####-----------------------------------SSS---------------TT-------##----------------------------------------
------------------------------------------####-----------------------------------------------------TT------###---------------------------1------------
----------------------------------------#-####------------------------#-------------1--------------TT-----####--------TT--------#--------------TT----T
----------------------------------#----##-####------------------------#----------------------------TT----#####--------TT--------#--------------TT----T
--K-M-----kkk-------------------k-#-------####----K-------------------#---kk----------------K------TT---######--------TT-k------#---gg---gggg--TT--F-T
XXXXXXXXXXXXXXXXXXX--X-XXXXXXXXXXXXXXXXXXXXXXXXXXXXXXXXXXXXXXXXXXXXXXXXXXXXXXXXXXXXXXXXXXXXXXXXXXXXXXXXXXXXXXXXXXXXXXXXXXXXXXXXXXXXXXXXXXXXXXXXXXXXXXX
XXXXXXXXXXXXXXXXXXX--X-XXXXXXXXXXXXXXXXXXXXXXXXXXXXXXXXXXXXXXXXXXXXXXXXXXXXXXXXXXXXXXXXXXXXXXXXXXXXXXXXXXXXXXXXXXXXXXXXXXXXXXXXXXXXXXXXXXXXXXXXXXXXXXX