------------------------------------------------------------------------------------------------------------------------------------------------------
------------------------------------------------------------------------------------------------------------------------------------------------------
------------------------------------------------------------------------------------------------------------------------------------------------------
------------------------------------------------------------------------------------------------------------------------------------------------------
------------------------------------------------------------------------------------------------------------------------------------------------------
---------------------------------------------------------------------------g--------------------------------------------------------------------------
---------------!---------------------------------------------------------SSSSSSSS---SSS!--------------@-----------SSS----S!!S-------------------------
------------------------------------------------------------------------------------------------------------------------------------------------------
------------------------------------------------------------------------------------------------------------------------------------------------------
---------------------------------------------------------1--------------g------------------------------------------------------------------------F----
---------!---S@S!S---------------------tt---------tt------------------S@S--------------C-----SU----!--!--!-----S----------SS------#--#----------##----
-------------------------------tt------tt---------tt-----------------------------------------------------------------------------##--##--------###----
---------------------tt--------tt------tt---------tt----------------------------------------------------------------------------###--###------####----
--------------g------tt--------tt-g----tt-----g-g-tt------------------------------------g-g--------k-----------------gg-g-g----####--####----#####----
XXXXXXXXXXXXXXXXXXXXXXXXXXXXXXXXXXXXXXXXXXXXXXXXXXXXXXXXXXXXXX--XXXXXXXXXXXXXXX---XXXXXXXXXXXXXXXXXXXXXXXXXXXXXXXXXXXXXXXXXXXXXXXXXXXXXXXXXXXXXXXX----
XXXXXXXXXXXXXXXXXXXXXXXXXXXXXXXXXXXXXXXXXXXXXXXXXXXXXXXXXXXXXX--XXXXXXXXXXXXXXX---XXXXXXXXXXXXXXXXXXXXXXXXXXXXXXXXXXXXXXXXXXXXXXXXXXXXXXXXXXXXXXXX----