-----------------Q-QQ------------------SSSSSSS---------------------------------------##---------------------------------------------------------------
------------------------------------------------------------------------------------------------------------------------------------------------------
---------------------------------------------------------------------------SSS---------------------------------------------------2----S!S-------------
-------------------------------------------------------R---------------------------------------------------------------------------K------------------
-------------------------g##-----------------------------------------------------------------------------------------C------------------------------@Q
-------------------------###--------------------------------------------------------------------------------------------------------------------------
-----Q---------------#######--------------------------------------------------------------------------------------------------------------------------
---------------------#######------------------------------------------------------------g-------------------------------------------------------------
---------------------#######--%%%--------------------------------------------TT-------SSSSS-----------------------------------------------------------
---------------------#######-------------------------------------------------TT-----------------------------------------------------------------------
------------TT-------#######-------------------------------------------------TT-----------------------------------------------------------------------
------------TT-------#######-------------------------------------------------TT----------------------------------tt-------TT--------------------------
------*-----TTTTTT-#########---tt-------TT-----------------------------------TT----------------------------------tt-------TT--------------------------
----M-*-----TTTTTT-#########---tt-------TT------------k-----k---g------------TT--------------------k--k---------ktt-----ggTT------------#---ggg-g--F--
XXXXXXXXXXXXXXXXXXXXXXXXXXXXXXXXXXXXXXXXXXXXXXXXXXXXXXXXXXXXXXXXXXXXXXXXXXXXXXXXXXXXXXXXXXX--XXXXXXXXXXXXXXXXXXXXXXXXXXXXXXXXXXXXXXXXXXXXXXXXXXXXXXXXX
XXXXXXXXXXXXXXXXXXXXXXXXXXXXXXXXXXXXXXXXXXXXXXXXXXXXXXXXXXXXXXXXXXXXXXXXXXXXXXXXXXXXXXXXXXX--XXXXXXXXXXXXXXXXXXXXXXXXXXXXXXXXXXXXXXXXXXXXXXXXXXXXXXXXX