-----------------------------SSSSSS----------------------------------------------------------------------------------------------%%%%-----------------
----------------------------------------------------------------------------------------------------------------TT------------------------------------
----------------------------------------------------------------SSS---------------------------------------------TT------------------------------------
----------------------------------------------------------------------------------------------------------------TT------------------------------------
---------------------------------------------------------------------------------------------------------------SXX------------------------------------
------------------------------------------------------------------------------------------------------------------------------------------------------
----------------------------------------------------------------------------------------------------------------------------------------------%%%-----
------------------------------------------------------------------------------------------------------------------------------------------------------
------------------------------------------SS-----------------------------SSSSSSS----------------------------------------------------------------------
-------------------SSSSSSSSSSSS------------------------------------------------------------------------------------------------------------------tt---
-------SSSSS----------------------------------------------------------------------QQQ---------------------@QQQQ-----------tt----------TT-----TT--tt---
----------------TT--------------------------------------------------------------------------------------------------------tt---TT---TTTT-----TT--tt---
----#-----------TT-------------------------------------------TT------------------------#----------TT----------------------tt---TT---TTTT-----TT--tt---
----#-----------TT----------SSSSSSSSSSSSSSSSSSSSSSSSSSS------TT------------------------#----------TT----------------------tt---TT---TTTT-----TT--tt---
XXXXXXXXXXXXXXXXXX--%%%%----------XXXXXXXXXXXXXXXXXXXXXXXXXXXXXXXXXXXXXX-------XXXXXXX-XXXXXXXXXXXXXXXXXXXXXXXXXXXXXXXXXXXXXXXXXXXXXXXXXXXXXXXX--X-X-X
XXXXXXXXXXXXXXXXXX----------------XXXXXXXXXXXXXXXXXXXXXXXXXXXXXXXXXXXXXX-------XXXXXXX-XXXXXXXXXXXXXXXXXXXXXXXXXXXXXXXXXXXXXXXXXXXXXXXXXXXXXXXX--X-X-X