---------------------------------%%%%%%-%%%%%------------------------------------------------------------S--------------------------------------------
---------------------R-----------------------------------------------------------------------------------S-U------------------------------------------
--------------------------SS--------------------------------%%%%%----SUSS--------------------------------SSSSSSS--------------------------------------
---------------------------------------------g---------------------------------y------------------------------K---------------------------------------
-------------------------------------------S@S---------------------------------##---------SS----------------------------------------------------------
------------------------------------------------------------------------------###---------SS-------%%%%%%%%%%--------------g--------------------------
----------------------------------------------------------------------------TT###---------SS-------------------%%%%%%--%%%%%%%%-------------%%--------
----------------------------------------------------------------------------TT###---------SS----------------------------------------------------------
------------------------------------------------------------------#---------TT###--------------------------------------------------------------TT-----
-----------------------------------------------------------------##---------TT###--------------------------------------------------------------TT-----
---------#-----------------------------------#------------------###---------TT###------#-------------------------------------------------------TT-----
-----C--##----------------------------------##-----------------####---------TT###-----##---------------TT--------------------------------------TT-----
-------###----------------------#-------TTTT##----------------#####------b--TT###----###--TT-----------TT-------B----------TT------------------TT-----
---#M-####----------gg----------#-k-gg--TTTT##---------------#######-----b--TT###---####--TT--ggg-g-g--TT-------b----------TT---------------k--TT--F--
XXXXXXXXXXXXXXXXXXXXXXXXXXXXXXXXXXXXXXXXXXXXXXXXXXXXXXXXXXXXXXXXXXXXXXXXXXXXXXXXXXXXXXXXXXXXXXXXXXXXX--XXXXXXXXXXXXXXXXXXXXXXXXXXXXXXXXXXXXXXXXXXXXXXX
XXXXXXXXXXXXXXXXXXXXXXXXXXXXXXXXXXXXXXXXXXXXXXXXXXXXXXXXXXXXXXXXXXXXXXXXXXXXXXXXXXXXXXXXXXXXXXXXXXXXX--XXXXXXXXXXXXXXXXXXXXXXXXXXXXXXXXXXXXXXXXXXXXXXX