--------------------------S!S-------------------------------------------------------------------------------------------------------------------------
--------------------------------------------------------------------------------------SSSS------------------------------------------------------------
------------------------------------------------------------------------------------------------------------------------------------------------------
S--------------------------------------------------------------------------R--------------------------------------------------------------------------
S----------------------------------------------%%%%%%----------------------------------------------------------------------------------1--------------
S-----------------------------------------------------------------------------------------------------------------------------------------------------
S-----------------------------------------------------------------------------------------------------------------------------------------------------
S---------------------------------------------------SS-----------------------------------------------SSSSSSSSSSSSSSSSSSSSS----------------------------
S-------------------------QQQ-----------------------------------------------TT------------------------------------------------------------------------
S---------------------------------------------------------------------------TT------------------------------------------------------------------------
S-------------------------------------------------------------#-----------SCTT---------------------##----------------------tt---#LSSSSSSSSSS----------
S------C------------------------------------------TT--TT------##------------TT---------------------##---tt-----------------tt---#-------------TT------
S----------------------b------------------TT------TT--TT---*--##--------------#------------------#-##---tt-----------------tt-###-----------TTTT------
S---M#------------#----b------------------TT------TT-kTT---*--##------gg---kkk#--------------K---#-##---tt---------------g-tt####----------kTTTT---F-#
XXXXXXXXXXXXXXXXXXXXXXXXXXXXX--X-XXXXXXXXXXXXXXXXXXXXXXXXXXXXXXXXXXXXXXXXXXXXXXXXXXXXXXXXXXXXXXXXXXXXXXXXXX--XXXXXXXXXXXXXXXXXXXXXXXXXXXXXXXXXXXXXXXXX
XXXXXXXXXXXXXXXXXXXXXXXXXXXXX--X-XXXXXXXXXXXXXXXXXXXXXXXXXXXXXXXXXXXXXXXXXXXXXXXXXXXXXXXXXXXXXXXXXXXXXXXXXX--XXXXXXXXXXXXXXXXXXXXXXXXXXXXXXXXXXXXXXXXX