------------------------------------------------------------------------------------------------------------------------------------------------------
------------------------------------------------------------------------------------------------------------------------------------------------------
------------------------------------------------------------------------------------------------------------------------------------------------------
------------------------------------------------------------------------------------------------------------------------------------------------------
------------------------------------------------------------------------------------------------------------------------------------------------------
------------------------------k-----------------------------------------------------------------------------------------------------------------------
-----------------------------##-------------------------------------------------SSSSS---?-------------------------##-----------Q-Q--------------------
----------------------------###-----------------------------------------------------------------------------------##----------------------------------
--------------#-----------k####---------------------------------------------------------------------------------#-##----------------------------------
-------------------g-------------------E------TT----------------------------------------------------------------#-##----------g-------------------F---
-------------------TT-----------------TT------TT-----------------------------C--------Q-----------------------#-#-##----------##---#-------------TT---
-------------------TT----------g------TT--tt--TT----------------------#---------------------TT----------------#-#-##-----------#---#-------------TT---
-------------------TT----------TT-----TT--tt--TT------------------K---#---------------------TT---------TT---#-#-#-##-----------#---##------------TT---
-------------------TT----------TT--g--TT--tt--TT-----k----------------#-----gg-------K-K----TT---------TT---#-#-#-##--------#--#---##--gg----k---TT---
XXXXXXXX----XXXXXXXXXX---XXXXXXXXXXXXXXXXXXXXXXXXXXXXXX---XXXXXXXXXX--XXXXXXXXXXXXXXXXXXXXXXXXXXXXXXXXXXXXX-X-X-X-XXXXXXXXXXXX-X---XXXXXXXXXXXXXXXX---
XXXXXXXX----XXXXXXXXXX---XXXXXXXXXXXXXXXXXXXXXXXXXXXXXX---XXXXXXXXXX--XXXXXXXXXXXXXXXXXXXXXXXXXXXXXXXXXXXXX-X-X-X-XXXXXXXXXXXX-X---XXXXXXXXXXXXXXXX---