---%--------------------------------------------------------------------------------------------------------------------------------------------------
---------------------------------------------------%%-------------------------------------------------------------------------------------------------
------------------------------------------------------------------------------------------------------------------------------------------------------
-------------------------------------------SSSSS------------------------------------------------------------------------------------------------------
-------------------------------------------------------------------------------------------------------------------SSS--------------------------------
---------------------------------SSSS---------------------------------E-----K-------g------------------------------SSS--------------------------------
---------------------------------SSSS--------------------------------TT----------S-##-----------------------------------------------------------------
---------------------------------SSSS--g-----------------------------TT------------##-------------------------B---------------------------------------
-----K---------------------------------SSSS!!------------------------TT------------##-------------------------b-SSSSSSSSSSSSSS------------------------
---------------#SSSSS-----------------------##-----------------------TT-----------###-----#-------------------B-SSSSSSSSSSSSSS------------------------
---------------#----------------------------##-----------------------TT-----------###-#--##----K-----##-------b-SSSSSSSSSSSSSS------------------------
----K----------#----T--------T--------------##----------------TTTTT--TT----------######-###---------###-------B---###-------T-------------------------
--------k-----##----T--------T---g---k------##---------r-----kTTTTT--TT------kk--##########---------###-------b---#-k----TTTT-----------gg---------F--
-------XXXXXXXXXXXXXXXXXXXXXXXXXXXXXXXXXXXXXXXXXX----XXXXXXXXXXXXXXXXXXXXXXXXXXXXXXXXXXXXXXXXXXXXXXXXXXXXXXXXXXXXXXXXXXXXXXXXXXXXXXXXXXXXX---------k--
XX-----MXXXXXXXXXXXXXXXXXXXXXXXXXXXXXXXXXXXXXXXXX----XXXXXXXXXXXXXXXXXXXXXXXXXXXXXXXXXXXXXXXXXXXXXXXXXXXXXXXXXXXXXXXXXXXXXXXXXXXXXXXXXXXXX--XXXXXXXXXX
XX-----XXXXXXXXXXXXXXXXXXXXXXXXXXXXXXXXXXXXXXXXXX----XXXXXXXXXXXXXXXXXXXXXXXXXXXXXXXXXXXXXXXXXXXXXXXXXXXXXXXXXXXXXXXXXXXXXXXXXXXXXXXXXXXXX--XXXXXXXXXX
