------------------------------------------------------------------------------------------------------------------------------------------------------
------------------------------------------------------------------------------------------------------------------------------------------------------
------------------------------------------------------------------------------------------------------------------------------------------------------
------------------------------------------------------------------------------------------------------------------------------------------------------
------------------------------------------------------------------------------------------------------------------------------------------------------
------------------------------------------------------------------------------------------------------------------------------------------------------
-----------------------------------------USSS---------------------------------------------------------------------------------y-----------------------
----------------------------------------------------------------------------------------------------------------------------#SSS----------------------
---------------------------------------------------------------------------------------------------------------------------##-------------------------
-------------------g-------------------E------TT--------------------------------------------------------------------------###1------------------------
-------------------TT-----------------TT------TT--------------------------------------------------------------------------###-------------------------
-------------------TT----------g------TT--tt--TT------------------------------------------------------------------------#-###--SSS-------TT-----------
-------------------TT----------TT-----TT--tt--TT-----------------------------------------------------------------------##-###------------TT-------F---
-------------------TT----------TT--g--TT--tt--TT-----k-----------k----ggg--------ggg--k----ggg----------------------------###---------y--TT-------y---
XXXXXXXX----XXXXXXXXXX---XXXXXXXXXXXXXXXXXXXXXXXXXXXXXX---XXXXXXXXXXXXXXXXXXXXXXXXXXXXXXXXXXXXXXXXXXXXXXXXXXXXXXXXXXXXXXXXXXXXXX---XXXXXXXXXXXXXXXX---
XXXXXXXX----XXXXXXXXXX---XXXXXXXXXXXXXXXXXXXXXXXXXXXXXX---XXXXXXXXXXXXXXXXXXXXXXXXXXXXXXXXXXXXXXXXXXXXXXXXXXXXXXXXXXXXXXXXXXXXXX---XXXXXXXXXXXXXXXX---