-----------------------------%%%%-----------TT---------------------------------------------------------%%%%%%%%---------------------------------------
--------------------------------------------TT-----------------------------------------------------------------------------------------------SSS------
-------------------------------g-----------SXXS-------------------------------------------------------------------------------------------------------
-----------------------%%%%%%%%%%%%%%-----------------------------------------------------------------------k-----------------------------------------
----------------------------?QQQQ--------------------------------------------------------------------------SQS-----------------------%%%%-------------
------------------------------------------------------------------------------------------------------------------------------------------------------
------------SS----------------------------------------------------------------------------------------------------------------------------------------
-------------------------------------------------------------------------------------------------------------------------SSSSS------------------------
------------------------------------------------------------------------------------------------------------------------------------------------------
------------------------------------------------------------------------------------#---------------------------------TT------------------------------
----------------------------SSS------------------------------Q-Q--------------------#---------------------#-----------TT---------TT----------tt-------
----------g-g-----k-----------------------------------------------------------------#--------SSSSS-------##-----------TT---------TT----------tt-------
----------TT########TT---------------------------------------------TT---------------##-------------b----###-----------TT---------TT---tt-----tt-TT----
----My----TT########TT-------------k--------------k-k-------K------TT---------------##-------------B---####-----------TT------y--TT---tt-----tt-TT-F--
XXXXXXXXXXXXXXXXXXXXXXXXXXXX---XXXXXXXXXXXXXXX-XXXXXXX-XXXXXXXXXXXXXXXXXXXX--XX-----XXXXXXXXXXXXXXXXXXXXXXXXXXXXXXXXXXXXXXXXXXXXXXXXXXXXXXXXXXXXX-XXXX
XXXXXXXXXXXXXXXXXXXXXXXXXXXX---XXXXXXXXXXXXXXX-XXXXXXX-XXXXXXXXXXXXXXXXXXXX--XX-----XXXXXXXXXXXXXXXXXXXXXXXXXXXXXXXXXXXXXXXXXXXXXXXXXXXXXXXXXXXXX-XXXX