----------------------------------------------------------------------------------------------------SSSSSS--------------------------------------------
----------------------------------------------------------------------------------------------------SSSSSC--------------------------------------------
------------------------------------------------%%--------------------------------------------------SSSSSS--------------------------------------------
----------------------------------------------------------------------------------------------------S-------------------------------------------------
---%%%%--------------------------------------------------Q--------------------------------%%--------S------------------------------SS-----------------
------------------------------------------------------------------------------------------------------------------------------------------------------
-----------------------------------------------------------------------------------------------------USS----------------------------------------------
------------------------------------------------------------------------------------------------------------------------------------------------------
------------------------------------------------------------------------------#--------------------------TT-------------------------------------------
-----------------------------------------------------------------------------##--------------------------TT-------------------------------------------
----------------------------------------------------------------------------###--------------------------TT-------------------------------------------
---------------TT----------------------------------------------------------####----------TT-------TT-----TT----------------TT------------TT-----------
---------------TT------------------------tt---------------TT----TT------#######----------TT-------TT-----TT---------tt-----TT------------TT-----------
----M-------y--TT-------y--------gggg----tt-------K-------TT----TT------#######--k--ggg--TT-------TT-----TT---------tt-----TT-------ggg--TT------F----
XXXXXXXXXXXXXXXXXXXXXXXXXXXXXXXXXXXXXXXXXXXXXXXXXXXXXXXXXXXXXXXXXXXXXXXXXXXXXXXXXXXXXXXXXXXXXXXXXXXXXXXXXXXXXXXXXXXXXXXXXXXXXXXXXXXXXXXXXXXXXXXXXX----
XXXXXXXXXXXXXXXXXXXXXXXXXXXXXXXXXXXXXXXXXXXXXXXXXXXXXXXXXXXXXXXXXXXXXXXXXXXXXXXXXXXXXXXXXXXXXXXXXXXXXXXXXXXXXXXXXXXXXXXXXXXXXXXXXXXXXXXXXXXXXXXXXX----