--------------------------------------------------------------------------------------------SSS------------------------------------------S------------
-----------------------------------------------------------------------------------------------------------------------------------------S-U----------
---------------------------------------------------------------------------------------------------------SSSSS--!------------------------SQSSSSS------
------------------------------SSSSSSSSSSSSSSSSSSSSSSSSSSSSSSSSSSSSSSSSS-------------------------------------------------------------------------------
------------------------------------------------------------------------------------------------------------------------------------------------------
------------------------------------SSSSSS------------------------------------------------------------------------------------------------------------
-----SSSSSS-------CSS------------------XX-------------------------------------------------------------------------------------------------------------
------------------------------------------------------------------------------------------------------------------------------------------------------
------------SSSS--2---------------------------USS-----------------------------------------------------------------------------------------------------
-----------------2-2---------------------------------------TT-----------------------------------1-----------------------------------------------------
-----------------##----------------------------------------TT-----------------------------------------------------------------------------------------
-------B---------##-------------------------E--------------TT-----------------------------------------------------------------------------------------
-------b-------#-#---------------------TT--TT--------------TT--TT-----------B--------------------------------------------------------XX------B--------
-------b-------#-#---------------------TT--TT--------------TT--TT-----------b--------------------------------------------------------XX------b--------
XXXXXXXXXXX-XXXXXXXXXXXXXXXXXXXXXXXXXXXXXXXXXXXX--XXXXXXXXXXXXXXXXXXXXXXXXXXXXXXXXXX-------------------------%%%%--------------------XXXXXXXXXXXXXXXXX
XXXXXXXXXXX-XXXXXXXXXXXXXXXXXXXXXXXXXXXXXXXXXXXX--XXXXXXXXXXXXXXXXXXXXXXXXXXXXXXXXXX-------------------------------------------------XXXXXXXXXXXXXXXXX