------------------------------------------------SSSSS---------#---------------------------------------------------------------------------------------
--------------------------------------------------------------#--SS-----------------------------------------------------------------------------------
--------------------------------------------------------------#---------------------------------------------------------------------------------------
-------------------------------------------------------------##---------------------------------------------------------------------------------------
--------------------------------------%%%%%%%---------------###---------------------------------------------------------------------------------------
--------------------------------------------------SSSSS----####-----------------------------------------------------------------------SSSSSSSSSSSSSS--
-----------SSS------------------------------S?S---------#######-------2-------------------------------------------------------------------------------
-----------------------------%%%%%%%%%-----------------########---------------------------------------------------------------------------------------
------------------------------------------------------#########--------------------------------------------#------------------------------------------
-----------------------------------------------------##########--------------tt---------------------------##------------------#-----------------------
----------------------------------------------------###########--------------tt--------------------------###------------------#----------------------#
---------------------------------------------------############--------------tt-------------------------####------------------#---------------------##
-----------------------------------------TT-------#############--------------tt-TT---------------------####--------------##---#--------------------###
-----------------------------------------TT------###############-------------tt-TT--------------------######---X---------##---#-----#-----#-------####
XXXXXXXXXXXXXXXXXXXXXXXXXXXXXXXXXXXXXXXXXXXXXXXXXXXXXXXXXXXXXXXXX--X-XXXXXXXXXXXXXXXXXXXXXXXXX---X-XXXXXXXXXXXXXXXXXXXXXXXXXXXXXXXXXXXXXXXXXXXXXXXXXXX
XXXXXXXXXXXXXXXXXXXXXXXXXXXXXXXXXXXXXXXXXXXXXXXXXXXXXXXXXXXXXXXXX--X-XXXXXXXXXXXXXXXXXXXXXXXXX---X-XXXXXXXXXXXXXXXXXXXXXXXXXXXXXXXXXXXXXXXXXXXXXXXXXXX