-----------------------------------------------------------------Q--------------!---------------------------------------------------------------#-----
------------------------------------------------------------------------------------------------------------------------------------------------#--SSS
------------------------------------------------------------------------------------------------------------------------------------------------#-----
---------------------------------------------------------------------------------------------------SSSSSSSSU------------------g-g-g-g-----------#-----
-----------------------------------------------K-B------------------------------------SS------------------------------------SSSSSSSSS-----------#-----
-------------------------------------------------b----------------------------------------------------------------------------------------------#-----
-----------------------------------------------#-------------------------------------------------------------------------------------y----------#-----
--------------------------#-------------------##---------------------------------------k------------------------------------SSSSSSSSSS----------#-----
-------------------------##------------------###--------------------------------------SSSSS------------------------------------------#SSSSS-----#-----
--------------------------------------------####------------------------------------------------------------------------------------##---------##-----
---------------#---------------------------#####----------------------#------------------------------------------------------------###--------###-----
--------------##--------------------TT----######---------SSS----------##------------------TT-----------------B--------------------####-------####-----
---TT--------###--------------------TT---#######----------------------###---------#-------TT----tt-----------b----#---TT---tt----###TT------#####-----
---TM-------####-------kkk----------TT--########----------y--y--------###---y-----#-------TT----tt-k---------B--k-#---TT---tt---####TT-----######--Fy-
XXXXXXXXXXXXXXXXXXXXXXXXXXXXXXXXXXXXXXXXXXXXXXXXXXXXXXXXXXXXXXXXXXXXXXXXXXXXXXXXXXX--XX-XXXXXXXXXXXXXXXXXXXXXXXXXXXXXXXXXXXXXXXXXXXXXXXXXXXXXXXXXXXXXX
XXXXXXXXXXXXXXXXXXXXXXXXXXXXXXXXXXXXXXXXXXXXXXXXXXXXXXXXXXXXXXXXXXXXXXXXXXXXXXXXXXX--XX-XXXXXXXXXXXXXXXXXXXXXXXXXXXXXXXXXXXXXXXXXXXXXXXXXXXXXXXXXXXXXX