--------------------------------------------------%%%%%%%%%-------------------------------------------------------------------------------------------
--------------------------k---------------------------------------------------------------------------------------------------------------------------
-------------------------##-----------------------------------------------------SS--------------------------------------------------------------------
------------------------###--SSSSSSS---------------------------------------------------------------------------------#--------------------------------
------------SS---------####--------------------------------------------------SS-------------------------------------##--------------------------------
------------SS--------#####----------------------------------------------------------------------------------------###--------------------------------
---------------------######---------------------------------------------------------------------------------------####--------------------------------
--------------------#######-------------------------------------------------------------------#------------------#####--------------------------------
-------------------########--------SQS-----------------------------R--------------------------#------------------#####--------------------------------
------------------#########-------------------------------------------------------------------#------------------#####--------------------------K-----
-----------------##########-------------TT---------%%%%%%%%%%%%%%-----------------------------#----------------#-#####-------------------------SSS!S--
---------------y###########----##-------TT---------------------------------------------------##-----TT---------#-#####--------------------------------
---------------############----##-------TT----------------###----------------------------tt-###-----TT-------#-#-#####--------------------------------
----M---------#############----##-k-ggg-TT----------#----####-------#--------------------tt####-----TT----kk-#-#-#####---y-----#-------------------F--
XXXXXXXXXXXXXXXXXXXXXXXXXXXXXX-XXXXXXXXXXXXXXXXXXXXXXXXXXXXXXXXXXXXXXXXXXXXXXXXXXXXXXXXXXXXXXXXXXXXXXXXXXXXXXXXXXXXXXXXXXXXXXXXX---XXXXXXXXXXXXXXXXXXX
XXXXXXXXXXXXXXXXXXXXXXXXXXXXXX-XXXXXXXXXXXXXXXXXXXXXXXXXXXXXXXXXXXXXXXXXXXXXXXXXXXXXXXXXXXXXXXXXXXXXXXXXXXXXXXXXXXXXXXXXXXXXXXXX---XXXXXXXXXXXXXXXXXXX