------------------------------------------------------------------------------------------------------------------------------------------------------
--SSSSSSSS--------------------------------------------------------------------------------------------------------------------------------------------
----------------------------------------------------------------------------------------------------------?QQQ----------------------------------------
------------------------------------------------------------------------------------------------------------------------------------------------------
-------------------------------------------------------------------------------C----------------------------------------------------------------------
------------------------------------------------------------------------------------------------------------------------------------------------------
--------------S---------------------------------------------------------------------------------------------------------------------------------------
-------------------------------------------------------------------------------------------------------------------%%%%-------------------------------
------------------------------------------------------------------------------------------------------------------------------------------------------
----------------SSSSSSSSSSSSSSSSSSSSSSSSS-------------------------------------------------------------------------------------------------------------
--------------------------------------------------%%%%%-----%%%%%%%%----------------------------------------------------------------------------------
-------------------------------#----------------------------------------------------------------------------------------------------------------------
----#----------------------#---#------------------------------------tt--------------tt-------tt------------------------------*------------TT----------
----#----------------------#-E-#------------------------------------tt--------------tt-------tt--------------------#---------*-----X------TT----------
XXXXXXXXXXXXX--X-XXXXXXXXXXXXXXX------XXXXXXXXXXXXXXXXXXXXXXXXXXXXXXXXXXXXXXXXXXXXXXXXXXXXXXXXXXXXXXXXXXXXXXXXXXXXXXXXXXXXXXXXXXXXXXXXX-XXXXXXXXXXXXXX
XXXXXXXXXXXXX--X-XXXXXXXXXXXXXXX------XXXXXXXXXXXXXXXXXXXXXXXXXXXXXXXXXXXXXXXXXXXXXXXXXXXXXXXXXXXXXXXXXXXXXXXXXXXXXXXXXXXXXXXXXXXXXXXXX-XXXXXXXXXXXXXX