-------------------------------------%%%%%------------------------------------SSSSSSSSSS--------------------------------------------------------------
------------------------------------------------------------------------------------------------------------------------------------------------------
---%%%%---------------------------------------------------SS---------------------------------%%%%-----------------------------------------------------
----------------------------------------------------------SS------------------------------------------------------------------------------------------
----------2-----------------------------------------------SS----------------------------------------------%%%---S!!S----------------------------------
----------------------------------------------------------SS------------------------------------------------------------------------------------------
--------------------------------------------------------SS--------------------------------------------------------------------------------------------
--------------------------------------------------------SS--------------------------------------------------------------------------------------------
--------------------------------------------------------SS-----------------------------------------SSSSSSS--------------------------------------------
--------------------------------------------------------SC--------------------------------------------------------------------------------------------
----------------------%%%-----#--------TT----USSQQQQQ---SSQS------------------------------------------------------------------------------------------
------------------------------#--------TT-----------------------SSSSSSSSSSSSSSSS----------------------------------------------------------------------
------------------------------#--------TT---------------------------------SU-------------------------##-----------------------tt----------------------
------------------------------#--------TT------------------------------------------------------------##-----------------------tt----------------------
XXXX---X-XX--X-XXXXXXXXXXXXXXXXXXXXXXXXXXXXXXXXXXXXXXXXXXX----------XXX-----XXXXXXXXXXXXXXXXXXXXXXXXXXX------------------XXXXXXXXXXXXXXXXXXXX--XXXXXXX
XXXX---X-XX--X-XXXXXXXXXXXXXXXXXXXXXXXXXXXXXXXXXXXXXXXXXXX----------XXX-----XXXXXXXXXXXXXXXXXXXXXXXXXXX------------------XXXXXXXXXXXXXXXXXXXX--XXXXXXX