----------------------------------------------------------------------------------------------------------------------SSS-----------------------------
-----------------------------------------------------------------------------------------------------------------------------------ggg----------------
----------------------------------------------------------------------------------------------------------------------------------SSSS----------------
---------------------------------------------------------------------------K------------------------------------------------------SSSS----------------
-------------------------------------------------------------------------------------------------------------------------------SSSSSSS----------------
---------------------------------------SSSSSSSSSSSSSSS------------------------------------------------------------------------------------------------
------------------------------------------SU----------------------------------------------------------------------------------------------------------
------------------------------------------------------------------------------SSSSS---------------------------------------------%%--------------------
-------------------#---------------------------------------------------------------------------------------------------------------SSSSSSSSSSS--------
------------------##------------------------------------------------------------#-----------------K---------------------------------------------------
-----------------###-----------------g----------------------#-------------------#---------------------------------------SCS---------------------------
---------------y####-----------------#-------------y-#------#-------------------#-------g-------------------------------------------------------------
---------------#####---------------g##----------y-##--------#-------------------#-------TT--------------------#---TT-------TT---TT--------------------
----M---------######-----r---------####--------######-------#-----gg------------#-------TT------------------k-#-k-TT-----k-TT---TT-----------k-----F--
XXXXXXXXXXXXXXXXXXXXXXXXXXXXXXXXXXXXXXXXXXXXXXXXXXXXXXXXXXXXXXXXXXXXXXXXXXXXXXXXXXXXXXXXXXXXXXXXXXXXXXXXXXXXXXXXXXXXXXXXXXXXXXXXXXXX-XXXXXXXXXXXXXXXXX
XXXXXXXXXXXXXXXXXXXXXXXXXXXXXXXXXXXXXXXXXXXXXXXXXXXXXXXXXXXXXXXXXXXXXXXXXXXXXXXXXXXXXXXXXXXXXXXXXXXXXXXXXXXXXXXXXXXXXXXXXXXXXXXXXXXX-XXXXXXXXXXXXXXXXX