------------------------------------------------------------------------------------------------------------------------------------------------------
------------------------------------------------------------------------------------------------------------------------------------------------------
------------------------------------------------------------%%%-----------------------------2------------------------------------------------#--------
--------------------------------------------------------------------------------------------------------------------------------------------##--------
--------------------S--------------------SSSSSS-------------------------------------------------------------------------------------!------###--------
------------------------------------------------------------------------------------------------------------------------------------------####--------
---------------------US---------------------------USSSSSS--------------------------------------------------------------------------------#####--------
-----%%%%-------------------------------------------------------------------------------------------------------------------------------######--------
---------------------------------------------------------------------------------------------------------------------------------------#######--------
------U------------SS-----------------------------------------------------------------------------------------------------------------########--------
-------------------------------------------------------------------------------------------------------------------------------------#########--------
---------------------------------y-------------------------------------TT-----------#-----------------TT--------------#-------------##########--------
------------------------------y-##-----##----------------------TT------TT-TT--------#-----------------TT-----------g-##------------############-------
---KM-----------gg-g---------#####--kk-##--------------g-g-----TT-----kTT-TT--------#-----------------TT---y---#--g#-##-----------##############---F--
XXXXXXXXXXXXXXXXXXXXXXXXXXXXXXXXXXXXXXXXXXXXXXXXXXXXXXXXXXXXXXXXXXXXXXXXXXXXXXXXXXXXXXXXXXXXXXXXXXXXXXXXXXXXXXXXXXXXXXXXXXXXXXXXXXXXXXXXXXXXXXXXXXXXXX
XXXXXXXXXXXXXXXXXXXXXXXXXXXXXXXXXXXXXXXXXXXXXXXXXXXXXXXXXXXXXXXXXXXXXXXXXXXXXXXXXXXXXXXXXXXXXXXXXXXXXXXXXXXXXXXXXXXXXXXXXXXXXXXXXXXXXXXXXXXXXXXXXXXXXX