-------------------------------------------------------------------------------------------------------------------------------------------------SSS--
------------------------------------------------------------------------------------------------------------------------------------------------------
------------------------------------------------------------------------------------------------------------------------------------------------------
------------r-----------------------------------------------------------------------------------------------------------------------------------------
----------%%%%----------------------QQQQ--------------------------------------------------------------------------------------------------------------
---------------------------------------------------------------------------------------------------------------------------#--------------------------
------------------SSSSSSSSSS?----------------------------------------------------------------------------------------------#-##-----------------------
------------------SSSSSSSSS------------------------------------------------------------------------------------------------#-##-----------------------
----------------SSSSSSSSSSS----------------------------------------------------------------------------------------------#-#-##-----------------------
-------------------------------------------------------------------------------------------------------------------------#-#-##---------------g-------
---------------------------------SSSSSS----------------------#-#-----------------------------------------------SS----#-#-#-#-#--###--#---SSSSSSS------
-------------------------------------------------------------#-#-----------------------------------------------------#-#-#-#-##-###--#----------------
----TT----------------------------B----------------------g-#-#------------------*-----------#---*----------------#-#-#-#-#-#-######--##---------------
----MT----gg------#---------------b-----------------gg--g#-#-#---g----K---k-----*----y------#---*--------k-------#-#-#-#-#-#-######--##-----------gF--
XXXXXXXXXXXXXXXXXXXXXXXXXXXXXXXXXXXXXXXXXXXXXXXXXXXXXXXXXXXXXXXXXXXXXXXXXXXXXXXXXXXXXX-XXXXXXXXXXXXXXXXXXXXXXXXXXXXXXXXXXXXXXXXXXXX--XX-X--XXXXXXXXXXX
XXXXXXXXXXXXXXXXXXXXXXXXXXXXXXXXXXXXXXXXXXXXXXXXXXXXXXXXXXXXXXXXXXXXXXXXXXXXXXXXXXXXXX-XXXXXXXXXXXXXXXXXXXXXXXXXXXXXXXXXXXXXXXXXXXX--XX-X--XXXXXXXXXXX