----------------SS------------------------------------------------#-----------------------------------------------------------------------------------
----------------SS-----------------------------------------------##--SSSSSSSSS-----------------------%%%%---------------------------------------------
----------------SS---------------------------SUS--------------#####---------------------------------------QQQ-----------------------------------------
----------------SS---------------TT--------------------------######----%%%-------------------------------------------SSSSSSSSSSSSSSSSSSS--------------
-------S-S------SS---------------TT-----------------------#########-------------------------------?-------------------------------S-------------------
-------S-S-U----SS---------------XX----------------------##########-----------------------------------------------------------------------------------
-------SSSSSSSSSSS-----------TT-------------------------###########---------------------------------------------------------------------QQQQQ---------
-----------------------------TT------------------------############-----------------------------------------------------------------------------------
-----------------------------TT----------------------#-############-----------------------------------------------------------------------------------
-----------------------------TT----------------------#-############--SSSSSSSSSSSSSSSSSSS--------------------------------------------------------------
-----------------------S@S---TT--------TT----------#-#--###########--------------------TT----------------S@S-----------------C------------------------
-----#-----------------------TT--------TT----------#-##-###########--------------------TT-------------------------------------------------------------
----##-------TT--------------TT--------TT--------#-#-##############--------------------TT-------------#------B---TT------------###--------------------
---###-------TT--------------TT--------TT--------#-#-##############--------------------TT-------------#------b---TT------------###--------------------
XXXXXXXXXXXXXXXXXXXXXXXXXXXXXXXXXXXXXX-XXXXXXXXXXXXXXXXXXXXXXXXXXXXXXXXXXXXXXXXXXXXXXXXXXXX--XXXXXXXXXXXXXXXXXXXXXXXXXXXXXXXXXXXXX---------%%%%-%%---X
XXXXXXXXXXXXXXXXXXXXXXXXXXXXXXXXXXXXXX-XXXXXXXXXXXXXXXXXXXXXXXXXXXXXXXXXXXXXXXXXXXXXXXXXXXX--XXXXXXXXXXXXXXXXXXXXXXXXXXXXXXXXXXXXX-------------------X