--US-----------------------------#--------------------------------------------------------?-----------------------------------------------------------
---------------------------------#-------------------------------R------------------------------------------------------------------------------------
------------------------------y--##----------------------------------------------------------------------------------------%%%%%%---------------------
------------------------------#--##-----------------------------------------SSSSSUSSSSSSSSSSSSSSSSSSSSSSSSSSSSSSSSSSSSSSSS----------------------------
-----------------------------##-------------------------------------------------------US------------------------------------SSSSSSSS------------------
---------------------------y###---------------------------------------------------------------------------Q-----------------SSSSSSSS------------------
---------------------------####---------------------------------------------------------------------------------------------SSSSSSSS------------------
--------------------------#####---------------------------------------------------------------------------------------------SCSSSSSS------------------
-------------------------######--------------------------------------------------#------------------------------------------SSS-----------------------
------------------------#######-------------------------------------------------##--------------------------------------------------------------------
---------TT------------########----------TT----------------TT-------------------##-------SSSS----------------------------------------------%%%%%%-----
---------TT-----------#########----------TT----------------TT-----------------#-##---------------------TT---------------------------------------------
---------TT-TT-------##########----------TT----------------TT----------------##-##---------#####-------TT------B-------------------------------TT-----
----M----TT-TT------############---------TT-------------k--TT----k--gg----------##--------######------kTT------b---------K-----------#------g--TT--F-#
XXXXXXXXXXXXXXXXXXXXXXXXXXXXXXXXXXXXXXXXXXXXXXXXXXXXX--XXXXXXXXXXXXXXXXXXXXXXXXXXXXXXXXXXXXXXXXXXXXXXXXXXXXXXXXXXXXXXXXXXXXXXXXXXXXXXXXXXXXXXXXXXXXXXX
XXXXXXXXXXXXXXXXXXXXXXXXXXXXXXXXXXXXXXXXXXXXXXXXXXXXX--XXXXXXXXXXXXXXXXXXXXXXXXXXXXXXXXXXXXXXXXXXXXXXXXXXXXXXXXXXXXXXXXXXXXXXXXXXXXXXXXXXXXXXXXXXXXXXX