------------------------------------------------------------------------------------------------------------------------------------------------------
-QQQQ--------%%%%%--------------------------SSSS------------------------------------------------------------------------------------------------------
----------------SSS--------------------------------S-------------------------------------------------------------k------------------------------------
-------------------------------------------------------------------------------------------------------------SQQQQ---------------------------TTT------
----------------------------------------------------------------------------------------------------------------------S---------------------#TTT------
----------------------------------------------------------------------------------------------------------------------S---------------------#TTT------
-----------------------------------------------------------------------------------------------------------------SSSS-S--------------------##TTT------
------------------------------------------------------------#------------------------------------------------------------------------------##TTT------
---------------------------%--------------------------------#-----------------------------------------------------------------SS-----------##TTT------
------------------------------------------------------------#-----------------------------------------------------------------------------###TTT------
----B---------------------------------------------------##-##---------------------------------------------2-------------------------------###TTT------
----b---------------------------------------------#-----##-##----------------------------------------------------------------------#------###TTT------
----b------------T-------------------T------------#----###-##-----------y--T----------------------------------##-----------------###------##-TTT------
----B------------T-TTT--------#------T-----------##----######-----------#--T--------B------------------------###-------------#######-----###-TTTSSSSSS
XXXXMXXXXXXXXXXXXXXXXXXXXX---##------T----------###--########-T---------#--T--------b---------------g-------####------------########---k####-TTT-k-F-T
XXXXXXXXXXXXXXXXXXXXXXXXXX-XXXXXXXXXXXXXXXXXXXXXXXXXXXXXXXXXXXXXXXXXXXXXXXXXXXXXXXXXXXXXXXXXXXXXXXXXXXXXXXXXXXXXXXX-----XXXXXXXXXXXX--XXXXXXXXXXXXXXXX