-----TT---------------------------------------------------------------------------------------------------------------------######--------------------
-----TT---------------------------------------------------------------------------------------------------------------Q-----####C---------------------
-----TT---------------------------------------------------------------------------------------------------------------------###-----------------------
-----TT----------------%%----------------------------------------------------------------------------------------------#--#####-----------------------
-----TT----------------------------------------------------------------------------------------------------------------#--#####-----US----------------
-----TT----------------------------------------------------------------------------------------------------------------#--#####-----------------------
-----TT----------------------------------------------------------------------------------------------------------------#-######-----------------------
-----TT------------------------------------------------------------------------------------------------------------#--#########-----------------------
-----TT---------------------------------------------USSSSSSSS---------------#--------------------------------------#--#########-----------------------
-ttt-TT----------------QQ--------------------------------------------------##--------------------------------------#-##########-----------------------
-ttt-TT-------------------------------------------------------------------###--------------------------------------#-##########-----------------------
-ttt-TT----------------TTTT----------------------------##-----------------###-------------------#------t----------#############------TT-----------kFT-
-ttt-TT----------------TTTT--------------TTT-----------##----------------####---------------XXXXXXXXXXXXXXXXXXXXXXXXXXXXXXXXXXXXXXXXXXXXXXXXXXXXXXXXX-
-ttt-TT---g------------TTTT--------------TTT-----------##-----XXXXX------####--TT-----------XXXXXXXXXXXXXXXXXXXXXXXXXXXXXXXXXXXXXXXXXXXXXXXXXXXXXXXXX-
XXXXMXXXXXXXXXXXXXXXXXXXXXXXXXXXXXXX-----TTT------y---###-----XXXXX-----######-TT-----------XXXXXXXXXXXXXXXXXXXXXXXXXXXXXXXXXXXXXXXXXXXXXXXXXXXXXXXXX-
XXXXXXXXXXXXXXXXXXXXXXXXXXXXXXXXXXXX-----XXXXXXXXXXXXXXXX-----XXXXX--XXXXXXXXXXXXXXXXXX-----XXXXXXXXXXXXXXXXXXXXXXXXXXXXXXXXXXXXXXXXXXXXXXXXXXXXXXXXX-