------------------------------------------------------------------------------------------------------------------------------------------------------
------------------------------------------------------------------------------------------------------------------------------------------------------
------------------------------------------------------------------------------------------------------------------------------------------------------
------------------------------------------------------------------------------------------------------------------------------------------------------
------------------------------------------------------------------%%%--------------------K------------------------------------------------------------
------------------------------------------------------------------------------------------------------------------------------------------------------
--------Q-Q-----------------------USS---------------SS------SS---------------------------##-------------------------------------------QQQQ------------
----------------------------------------------------------------------------------------###-----------------------------------------------------------
---------------------------------------------------------------------------------------####-----------------------------------------------------------
-------------------------------------------b-------------------K----------------------#####---------------------------------------------y-------------
--------Q-Q------------------------------SS#CS---------------SSSSSSS----------------TT#####-----------TT--------------TT------------QQ?SSQQQ----------
-------------------------------K---B-------------------TT---------------TT---------#TT#####-----------TT--------------TT------------------------------
--------------------------B--------b---------K-B-------TT---------------TT--------##TT#####-----------TT--------------TT------------------------------
------------y-------------b--------B-----------b-------TT---------------TT-------###TT#####--------y--TT---y------y---TT--------------------------F---
XXXXXXXXXXXXXXXXXXXXXXXXXXXXXXXXXXXXXXXXXXXXXXXXXXXX--XXXXXXXXXXXXXXXXXXXXXXXXXXXXXXXXXXXXXXXXXXXXXXXXXXXXXXXXXXXXXXXXXXXXXXXXXXXXXXXXX--XXXXXXXXXX---
XXXXXXXXXXXXXXXXXXXXXXXXXXXXXXXXXXXXXXXXXXXXXXXXXXXX--XXXXXXXXXXXXXXXXXXXXXXXXXXXXXXXXXXXXXXXXXXXXXXXXXXXXXXXXXXXXXXXXXXXXXXXXXXXXXXXXX--XXXXXXXXXX---