----------------------------------%%%%%----------------------------Q----------------------------------------------##----------------------------------
-----------------------------g------------------------------------------------------------------------------------##----------------------------------
-------------------------#####-----------------------------------------%%%%--------------##--#------------------------------SSSSSS--------------------
------------------------##---------------------------------------------------------------##--#-------C--------------------------K---------------------
-----------------------###-------------------------------------------------Q----------y--#---##--#----------------------------------------------------
----------------------####----------------------------------------SSS-----------------#--#-E-##--#-#-------------------------K------------------------
---------------------#####--%%%----------------------%%%-------------1---------------##------SSSSSSS--------------------------------------------------
--------------------######--------------------SSSSSS--------------------------------###---------------------------------------------------------------
-------------------#######---------------------------------------------------------####---SS------------USSS-----------------#------------------------
------------------########--------------------------------------------------------#####------------------------------K------##------------------------
-----------#-#-#--########-------------------------------------------------------######------------------------------------###------------------------
-----------#-#-##-########------------------------------------------------------#######---------------E------------------y####-----------SSSSSSSSSSSSS
-------g-###------########----------#-------------------------TT---------------########--------------TT--TT-----*--------#####------------------#-----
----M-g#-###-----#########----------#---------k---------------TT---y----y-----#########----r---------TT--TT-----*-------######-------g-g------k-#--F--
XXXXXXXXXXXXXXXXXXXXXXXXXXXXXXXXXXXXXXXX-XXX-XXXXXXXXXXXXXXXXXXXXXXXXXXXXXXXXXXXXXXXXXXXXXXXXXXXXXXXXXXXXXXXXXXXXXXXXXXXXXXXXX---XXXXXXXXXXXXXXXXXXXXX
XXXXXXXXXXXXXXXXXXXXXXXXXXXXXXXXXXXXXXXX-XXX-XXXXXXXXXXXXXXXXXXXXXXXXXXXXXXXXXXXXXXXXXXXXXXXXXXXXXXXXXXXXXXXXXXXXXXXXXXXXXXXXX---XXXXXXXXXXXXXXXXXXXXX