------------------------------------------------------------------------------------------------------------------------------------------------------
------------------------------------------------------------------------------------------------------------------------------------------------------
------------------------------------------------------------------------------------------------------------------------------------------------------
------------------------------------------------------------------------------------------------------------------------------------------------------
---------------------------------------------------------------------------K--------------------------------------------------------------------------
------------------------------------------------------------------------------------------------------------------------------------------------------
--------------------USSS--------SSCSS------%%%%----------------------------##--------------------USS------%%%%----------------------------------------
-----------------------------------------------------R--------------------###---------------------------------------R---------------------------------
-----------------------------------------------%%%-----------------------####---------------------------------%%%-------------------------------------
-----------------------------b-------------------K----------------------#####-----------------------------b-------------------K-----------------------
---------------------------SS#CS---------------SSSSSSS----------------TT#####---------------------------SS#CS---------------SSSSSSS-------------------
-----------------K---B-------------------TT---------------TT---------#TT#####-----------------K---B-------------------TT---------------TT---------F---
------------B--------b---------K-B-------TT---------------TT--------##TT#####------------B--------b---------K-B-------TT---------------TT---------B---
------------b--------B-----------b-------TT---------------TT-------###TT#####------------b--------B-----------b-------TT---------------TT---------b---
XXXXXXXXXXXXXXXXXXXXXXXXXXXXXXXXXXXXXX--XXXXXXXXXXXXXXXXXXXXXXXXXXXXXXXXXXXXXXXXXXXXXXXXXXXXXXXXXXXXXXXXXXXXXXXXXXX--XXXXXXXXXXXXXXXXXXXXXXXXXXXXXX---
XXXXXXXXXXXXXXXXXXXXXXXXXXXXXXXXXXXXXX--XXXXXXXXXXXXXXXXXXXXXXXXXXXXXXXXXXXXXXXXXXXXXXXXXXXXXXXXXXXXXXXXXXXXXXXXXXX--XXXXXXXXXXXXXXXXXXXXXXXXXXXXXX---