---------------------------------------------------------------------------------USS!S----------------------------------------------------------------
------------------------------------------------------------------------------------------------------------------------------------------------------
-------------------------------------------------------------------------SSSSCS--------------------------%%%------------------------------------------
------------------------------------------------------------------------------------------------------------------------------------------------------
-------------------------------------------------------------------------------------------------------------------------------------------------%%%%-
------------------------------------------------------------------------------------------------------------------------------------------------------
-------------2---------------------------------------------------------------------------------------------------------%%%%%%-------------------------
------------------------------------------------------------------------------------------------------------------------------------------------------
---------------------------------------------------##-------------------------------------------------------------------------------------------------
-----------------SSSSSSSSS-?----------------------###-------------------------------------------------------------------------------------------------
-----------------------------tt----####----------####------%%%%%--------------------------------------------------------------------------------------
--------------TT-------------tt---##--#---TT----#####-------------------------------------------------------------------------------------------------
--------------TT-------------tt-TT##--#---TT---######------------###-------------------##---------------------------------------------------------TT--
--------------TT-------------tt-TT##--#---TT--#######------------###-------------------##---------------------------------------------------------TT--
XXXXXXXXXXXXXXXXXXXXXXXXX--XXXXXXXXXXXXXXXXXXXXXXXXXXXXXXXXXXXXXXXXXXXXXXXXXXXXXXXXXXXXXXXX--XXXXXXX-------------%%%%%%%%%%%%%%%%%%%%-----XXXXXXXXXXXX
XXXXXXXXXXXXXXXXXXXXXXXXX--XXXXXXXXXXXXXXXXXXXXXXXXXXXXXXXXXXXXXXXXXXXXXXXXXXXXXXXXXXXXXXXX--XXXXXXX--------------------------------------XXXXXXXXXXXX