----------------------SS----------------------------------TT--------------------------------------------------------SSS-------------------------------
----------------------SS----------------------------------TT-----------------------------------K------------------------------------------------------
---------------------------------------------------------SXXS-----------------------------------------------------------------------------------------
S-----------------------------------------------------------------------------------------------------------------------------------------------------
S---------------S----------------------C----------------------------------------------------------------------------------------------y--------SSSSS--
S-----------------------------------------------------------------------------------------------------------Q--?Q-------------------#SSS--------------
S----------------------------------------------------------------------------------------------------------------------------------##-----------------
S---------------------------------------------------------------SSSSSSSSSSSSSSSSSSSSSS--------------------------------------------###1----------------
S--------------TT-------------------------------------------------------#--------------------------------------------------------####---------------SS
S--------------TT-------------------------------------------------------#-------------------------------------------------------#####---------------SS
S---S@S!S------TT-----------TT------------------------------------------#---------SSS---------#---------------------------SS---######----------------S
S-----------y--TT-----------TT----------SSSSSSSSSSSSSSSS-?Q--------#---##--------------------##------------------C------------#######---------g------S
S--------######-------------TT-----------------------B---------#---#---##---TT--------------###-----------#-----------------TT#######---------TT-----S
S---Mggg#######------#------TT-----------------------b---------#-E-#-E-##---TT--kk----gg---####-----ggg---#----#----gg-----kTT#######---------TT--F--S
XXXXXXXXXXXXXXXXXXXXXXXXXXXXXXXXXXXXXXXXXXXX----XXXXXXXXXXXXXXXXXXXXXXXXXXXXXXXXXXXXXXXXXXXXXXXXXXXXXXXXXXXXXXXXXXXXXXXXXXXXXXXXXXXXXXXXXXXXXXXXXXX--X
XXXXXXXXXXXXXXXXXXXXXXXXXXXXXXXXXXXXXXXXXXXX----XXXXXXXXXXXXXXXXXXXXXXXXXXXXXXXXXXXXXXXXXXXXXXXXXXXXXXXXXXXXXXXXXXXXXXXXXXXXXXXXXXXXXXXXXXXXXXXXXXX--X