----------------------------------------------SS-----------------------------------QQ?SS-------------------------------------C------------------------
------------------------------------------------------------------------------------------------------------------------------------------------------
----------SSSSS---------------------------------------------------?--------------------------C--------------------------------------------------------
------------------------------------------------------------------------------------------------------------------------------------------------------
-----------------------------------------------------------%%%%---------------------------------------------------------------------------------------
-------------------------TT----------------------------SSS--------------------------------------------------------------------------------------------
--------SU---------------TT--------------------------------------%%%%%%------------------------------------------------%%%%------------------LSS------
-------------------------TT---------------------------------------------------------------------------------------------------------------------------
-----------------------S----------------------------!----------------------------------------------------------------------SSS------------------------
-----------------------S-U---------------------------------------------------------------------TT------------------------------------------------TT---
-----------------------SSS------------------------------------------------------SQS------------TT------SQS---------------------------------------TT---
---------TT--------------------------------------------------------C---------------------------TT------------------------------------------------TT---
---------TT-------------------TT--------------------------TT----------*------------------------TT------------------------------------------------TT---
---------TT--------%%%%%------TT--------------------------TT-----#----*------------------------TT------------------------------------------------TT---
XXXXXXXXXXXXXXXXX-----XXXXXXXXXXXXXXXXXXXXXXXXXXXXXXXXXXXXXXXXXXXXXXXXXXXXXXXXXXXXXXXXXXXXXXXXXXXXXX--------%%%%%------%%%%%%%%%%%%%%%%%%----XXXXXXXXX
XXXXXXXXXXXXXXXXX-----XXXXXXXXXXXXXXXXXXXXXXXXXXXXXXXXXXXXXXXXXXXXXXXXXXXXXXXXXXXXXXXXXXXXXXXXXXXXXX-----------------------------------------XXXXXXXXX