-------------------------------------SSS-------------------------------------------------------SXXS---------------------------SSSSSS?SSSS----g--------
------------------------------------------------------------------------------------------------------------------------------------------%%%%%%%%%---
---------------------------------------------------------------------------------------Q-Q-QQ-----------------------------------------SSSSSS----------
S----SSSSS----------------------------------------------------------------------------------------------------------------------------SSSSSS----------
S------%%%-----------------------------------------------1----------------------------------------------------------------------------SSSSSS----------
S-------------------------------------------------------------------------------------K-----------------------------------------------SSSSSS----------
S-----------------------------------------------------------------------------SSSS?SSSSSSSSS------------------------------------SSSSSSSSSSSS----------
S--------------------------------------------------------ggg----------------------------------TT--------------------------------SSSSSSSCSSSS----------
S-------------------------------SSS---------------------SSSSSSSS---------------------###------TT--------------------------------SSSSSSSSSSSS----SS----
S-------------------------------------------------------SSSSSSSS-------------g------####------TT--------------------------------SSS-------------------
S-----%%%%----S@S!S-------------------------------------SSSSSSS-U----------S@S-----#####------TT-----------------y--------------SSS-------------------
S-------------------------------------------------------SSS---S-S-----------------######------TT-----------------XSSSSSSSSSSSS---------tt-------------
S--------------------------TT---------------------------SSS---SSS------------###########---TT-TT----------------XXXXXXXX---###----B----tt-------------
S---M----------gg----------TT--------------------------------------------k--############---TT-TT---------------XXXXXXXXX---###----b---ktt----#-----F--
XXXXXXXXXXXXXXXXXXXXXXXXXXXXXXXXXXXXXXXXXXXXXXXXXXXXXXXXXXXXXXXXXXXXXXXXXXXXXXXXXXXXXXXXXXXXXXXXXXXXXXXX-XXXXXXXXXXXXXXXX--XXXXXXXXXXXXXXXXXXXXXXXXXXX
XXXXXXXXXXXXXXXXXXXXXXXXXXXXXXXXXXXXXXXXXXXXXXXXXXXXXXXXXXXXXXXXXXXXXXXXXXXXXXXXXXXXXXXXXXXXXXXXXXXXXXXX-XXXXXXXXXXXXXXXX--XXXXXXXXXXXXXXXXXXXXXXXXXXX