-------------------------------------------------------------------%-------------------------------------------------SSSSS-%%%%%------------S---------
------------------------------------------------------------------------------------------------------------------------------------------------------
--------------------------------------------------------------------%%%%%%%%%%%%%%%%%%----------------------------------------------------------------
------------------------------------------------------------------------------------------------------------------------------------------------------
--------------------------------------------------y---------------------------------------------------------------------------------------------------
----%%%%%---------------------------------------SSS-----------------------------------------------------------------------------------SSSSS-----------
--------------------------------------------------------------------------------------------------------------------------------------SSSSS-----------
-----------------------------------------------------------------------------------------------------------------T---LSSSSSSSS!-----------------------
-----------------------------------------------------------------------------------------------------------------T-------------?----------------------
-----------------------------------------------------------------------------------------------------------------T----------------------------K-------
----------------------------------SSSSSSS------------------------------------------------------------------------T-------ttttt------------------------
-?SSS------------------------------------------------------------------------------------K-------B---------------T-------ttttt------------------------
---------------------------------------------------------------------t------------------SSSS--E--b---------------T-------ttttt-----------#------------
---------g------------------------------?-----------------%%%%%%-----t-----------------------TTT-B---------------T-------ttttt----------##------------
XX-----M-#----T------k---k----------g--------------------------------t-k----*---------gg-----TTT-b---#------gggggT-------ttttt---------###-k-------Fk-
XX-----XXXXXXXXXXXXXXXXXXXXXX-XXXXXXXXXXXXXXXXXXXXXXXXXXXXXXXXXXXXXXXXXXXXXXXXXXXXXXXXXXXXX--XXXXXXXXXXXXXXXXXXXXXXXXXXXXXXXXXXXXXXXXXXXXXXXX-----XXXX