--------------------------------------------------------------------------------%%%-------------------------------------------------------------------
-----------------------------------------------------------------------------------------------------------------------------------------------TT-----
-----------------------------------------------------------------------------------------------------------------------------------------------TT-----
S-----------------------------------------------------------------------------------------------------U----------------------------------------TT-----
S--------------------------------------------------------------------------------------------------------US------------------------------------TT-----
S-------------------------1--------------------------------------------------------------------------------------------------------------------TT-----
S----------------------------------------------------------------------------------------------------------------------------------------------XX-----
S------------------------------------------------------------------------------------------------------SS---------------------------------------------
S----------------------------------------------------------------------------------------------------------##-----------------------------------------
S------------------------------ggg------------------------------------------------------------------------###----------------------------------------#
S-------------------SSS---#########------------------SSS-------------------------------------------------####------TT------?-----------------------F##
S-------------------------#-----------TT------------------------------------TT--------------------------#####------TT------------------------------###
S------tt----TT--------####---tt--TT--TT-----------------------TT---------TTTT-------------------------######------TT-----------------TT----------####
S---M--tt----TT--------####---tt-kTT--TT----kk-----g-g-g-------TT---------TTTT----gg------------------#######---k--TT-----------------TT---------#####
XXXXXXXXXXXXXXXXXXXXXXXXXXXXXXXXXXXXXXXXXXXXXXXXXXXXXXXXXXXXXXXXXXXXXXXXXXXXXXXXXXXXXXXXXXXXXXXXXXXXXXXXXXXXXXXXXXXXXXXXXXXXXXX-----XXXXXXXXXXXXXXXXXX
XXXXXXXXXXXXXXXXXXXXXXXXXXXXXXXXXXXXXXXXXXXXXXXXXXXXXXXXXXXXXXXXXXXXXXXXXXXXXXXXXXXXXXXXXXXXXXXXXXXXXXXXXXXXXXXXXXXXXXXXXXXXXXX-----XXXXXXXXXXXXXXXXXX