--------------------SSSSCSSSSS-----------------%%%%%----------------------------------------------------------@QQQQQ----------------------------------
--------------------S----------------------------------------------------------------------------------------------------------------SSSSS------------
--------------------S---------------------------------------------------------------------------------------------------------------------------------
------------------------------------------------------------------------------------------------------------------------------------------------------
--------------------------------------------------------------------------------------------------------------------------------SSSS------------------
-------------------------------------SSSSSSSSSSSSSSSSS--------------------------------------------------------------------------SSSS------------------
--------------------------------------------------------------------------------------------------2-----------------------------SSSS------------------
------------------------------------------------------------------------------------------------------------------------------------------------------
------------------------#####-------------------------------------------------------------------------------------------------------------------------
------------------------#----------------------------------------------------------------------------------------------------------------------TT-----
---------------#--------#--------------SSSSSSSS----------------------------------------------------------------------------------------tt------TT-----
--------------##--------#--------%%%----------------SSS--------------------------------------------------------------------------------tt------XX-----
-------------###--------#-TT--------------TT----------------------------------------------------------------------TT---##--------------tt--TT---------
------------####--------#-TT--------------TT----------------#-----------------------------------------------------TT---##--------------tt--TT---------
XXXXXXXXXXXXXXXX--------X-XXXXXXXXXXXXXXXXXXXXXXXXXXXXXXXXXXXXXXXXXXXXXXXXXXXXXXXXXXXXXXXXX----------XXXXXXXXX--XXXXX--XX--XXXXXXXXXXXXXXXXXXXXXXXXXX-
XXXXXXXXXXXXXXXX--------X-XXXXXXXXXXXXXXXXXXXXXXXXXXXXXXXXXXXXXXXXXXXXXXXXXXXXXXXXXXXXXXXXX----------XXXXXXXXX--XXXXX--XX--XXXXXXXXXXXXXXXXXXXXXXXXXX-