------------------------------------------------------------------------------------------------------------------------------------------------------
-------------------------------------------------------------------%%%%%%%%%%%%-----------------------------------------------------------------------
------------------------------------------------------------------------------------------------------------------------------------------------------
------------------------------------------------------------------------------------------------------------------------------------------------------
----------!---------QQQQ----------------------------------------------------------------------------------------%%%-%%%%%%%%%--%%%%-------------------
-------------------------------------------------------------------------------------------SSSSSSS----------------------------------------------------
--!--------------------------------------------------------SSS---------------------------------------------------------------#------------------------
-------------------------------------------------------------K--------------------U-----------------------------------------##--1---------------------
--------@QQQQ----------------------------------------------------------------------------------------------LSS!S-----------###------------------------
---------------------%%%-------------------C--------------K---------------------------------------------------------------####------SSSSSSSSSSSSSSSSS-
-----1--------------------TT----!--!--------------tt---SSSSSS-----------------!------------------------S------------------####--SSSSSSSSSS------------
--------------------------TT-------------#----TT--tt----------------------------------------------------------------U---#-####------SSSSSS------------
--------------------------TT------------##----TT--tt-----tt----------------------K-B-----------------------------------##-##TT-------tt--TT-----------
----Mgg------k-----------kTT----k------###----TT--tt-g--ktt------------------------b------------gg---g-gggg---------------##TT-----g-tt--TT--------F--
XXXXXXXXXXXXXXXXXXXXXXXXXXXXXXXXXXXXXXXXX-XXXXXXXXXXXXXXXXXXXXXXXXXXXXXXXXXXXXXXXXXXXXXXXXXXXXXXXXXXXXXXXXXXXXXXXXXXXXXXXXXXXXXXXXXXXXXXXXXXXXXXXX-XX-
XXXXXXXXXXXXXXXXXXXXXXXXXXXXXXXXXXXXXXXXX-XXXXXXXXXXXXXXXXXXXXXXXXXXXXXXXXXXXXXXXXXXXXXXXXXXXXXXXXXXXXXXXXXXXXXXXXXXXXXXXXXXXXXXXXXXXXXXXXXXXXXXXX-XX-