------------------------------------------------------------------------------------------------------------------------------------------------------
------------------------------------------------------------------------------------------------------------------------------------------------------
----------------------------S!SSSSSSS----------------------------------SSS----------------------------------------------------------------------------
--------------------SS--------------------------------------------------------------------------------------------------------------------------------
--------------------SS-----------------------------------------------------------------------------------------------------------------------?--------
-------------------------------------------------------------------------------------------------------------------------------SSSSSSSSS--------------
--------------------------------------------------------------------#---------------------------------------------------------------------------------
--------------------------------------------------------------------#---------%%%%%%%%%---------------------------------------------------------------
------------------------------------------------------------------###---------------------------!-----------------------------------------------------
-------------------------SSS------------------T------------------k###---------------------------------------------------------------------------------
----------------------------------------------T------------------####----------------------TTS--------------------------------------------------------
--------------------------y-------------------T------------------####-----------------g----TT-------------------------------------##------------------
-------------------------###--------*---------T-----------------#####------g----------T----TT----------------------------------B-###------------------
------T-----------------####-k------*-y-------T-kk--------------XXXXXXXXXXXXXXXXXXXXXXXXXXXXXXX-------TT----------------gg-----b-###---g-----------F--
XXXXMXXXXXXXXXXXXXXXXXXXXXXXXXXXXXXXXXXXXXXXXXXXXXXXXXXXXXXXXXXXXXXXXXXXXXXXXXXXXXXXXXXXXXXXXXX----k--TT--S--XXXXXXXXXXXXXXXXXXXXXXXXXXXXXXXXXXXXXXXXX
XXXXXXXXXXXXXXXXXXXXXXXXXXXXXXXXXXXXXXXXXXXXXXXXXXXXXXXXXXXXXXXXXXXXXXXXXXXXXXXXXXXXXXXXXXXXXXX---XXXXXX--X--XXXXXXXXXXXXXXXXXXXXXXXXXXXXXXXXXXXXXXXXX