------------SSSSSS--------------------------------------------------------------------------------------------------------------%%%-------------------
------------SSSSSS------------------------------------------------------------------------------------------------------------------------------------
------------SSSSSS-----------------SSSSSSSQQ------------------------------------------------------------------SS--------------------------------------
------------SSSSSS---------------------------K--------------------------------------------------------------------------------------------------------
---------------------------------------------------------------------------------------Q-Q------------------------------------------------------------
---SSSSS----------------------------------------------------------------------------------------------------------------------------------------------
--------------------------------------------------------------------------------------------------SS?SSS-------------------LSS------------------------
-----------------------------------------------------TT-------------------------------------------------------------------------------------------SSSS
-----------------------------------------------------TT----LSSS---------------------SSS---------------------------------------------------------------
-----------------------------------------------------TT----------------------------------------------------------------------------------#------------
--SS-------------------S-----------------------------TT-------------------------!--------------------------g----------------------------##------------
----------------------------------------------TT-----TT-------------g--------------------------------------#--------K------------------###------------
-----TT------------------------TT-------------TT-----TT-------------TT-----TT----------------------------g###---------------TT--------####-------TT---
---kMTT--------------g-ggg-----TT-------------TT-----TT-------------TT---g-TT---k--ggg-----------r-------#####---------y----TT---y---#####-------TTF--
XXXXXXXXXXXXXXXXXXXXXXXXXXXXXXXXXXXXXXXXXXXXXXXXXXXXXXXXXXXXXXXXXXXXXXXXXXXXXXXXXXXXXXXXXXXXX--XXXXXXXXXXXXXXXXX-XXXXXXXXXXXXXXXXXXXXXXXXXXXXXXXXXXXXX
XXXXXXXXXXXXXXXXXXXXXXXXXXXXXXXXXXXXXXXXXXXXXXXXXXXXXXXXXXXXXXXXXXXXXXXXXXXXXXXXXXXXXXXXXXXXX--XXXXXXXXXXXXXXXXX-XXXXXXXXXXXXXXXXXXXXXXXXXXXXXXXXXXXXX