------------------------------------------------------------------------------------------------------------------------------------------------------
------------------------------------------------------------------------------------------------------------------------------------------------------
-------------------------------------------R----------------------------------------------------------------------------------------------------------
--------------------------------------------------------------------------------------------------------------------%%--------------------------------
--------------%%%%%%%--------%%%%%%%%%%%%-------------------------------------------------------------------------------------------------------------
------------------------------------------------------------------------------------------------------------------------------------------------------
-----------------------------------------------------------------------------------------------------------------------g------------------------------
-----------------------------------------------------------------------------------------------------------------------#------------------------------
---------------------------------------------------------------------------------------------------------------------g##------2-----------------------
---------------------------------------SSSSSSLSSSSSSSSSSSSSSSSSSSSSSSSSSSSSSSSSS--------------#-----K-----------y----###------------------------------
-------------------------%%%%%%---------------QQQ------SCSSSSS-------------------------------##-SSSSSS--SS------#######-------------------------------
------------------------------------TT-------------------K---------------------------------y###---------------y#########------------------------------
--------------------------TT---tt---TT---##------------------------------------------------###TT--------------#########-------------------------------
----M---------------------TT--ktt---TT---##------------K----------------k-----------------####TT-----g-g-----###########---gggg-------y-------k-gggF--
XXXXXXXXXXXXXXXXXXXXXXXXXXXXXXXXXXXXXXX--XXXXXXXXXXXXXXXXXXXXXXXXXXXXXXXXXXXXXXXXXXX---XXXXXXXXXXXXXXXXXXXXXXXXXXXXXXXXXXXXXXXXX----XXXXXXXXXXXXXXXXXX
XXXXXXXXXXXXXXXXXXXXXXXXXXXXXXXXXXXXXXX--XXXXXXXXXXXXXXXXXXXXXXXXXXXXXXXXXXXXXXXXXXX---XXXXXXXXXXXXXXXXXXXXXXXXXXXXXXXXXXXXXXXXX----XXXXXXXXXXXXXXXXXX