-----------------SSSQQQQ-----------------------------------------------------------------------------SSSSSSSSSSS--------------------------------------
-------------------------------------------------------------------------------------------------------------------------------SSSSSS-----------------
--------------------------------------------------------------------------------------?---------------------------------------------C-----------------
------------------------------------------------------------------------------------------------------------------------------------------------------
-------------SSSSSSSSS----------------------------------------------------------------------------------------------------#---------------------------
---------------------------------------------------------------------------------------------------TT--------------------##--------------------SSU----
---------------------------------------------------------------------------------------------------TT----------SSSSS----###---------------------------
-------%%%%%%%%------------------------------------------------------------------------------------XX------------------####---------------------------
---------####----------------------------------------------------------------------------------TT---------------------#####---------------------------
---------####----------------------------------------------------------------------------------TT--------------------######---------------------------
---------####-----------------------------------%%%------------------------------------##------TT----------SSS------#######-----------%%%-------------
---------####--------B------------------------------------------------------Q----------##------TT------------------########---------------------------
-------######--------b--------TT----------------------------------------TT-----------####------TT-TT-#------------#########--------------tt---tt------
-------######--------B--------TT----------------------------------------TT-----------####------TT-TT-#-----------##########--------------tt---tt------
XXXXXXXXXXXXXXXXXXXXXXXXXXXXXXXX--XXXXX-------%%%%%%%%%------------XXXXXXXXXXXXXXXX--XXXXXXXXXXXXXXX-XXXXXXXXXXXXXXXXXXXXXXXXXXXXXXXXXXXXXXXXXXXXXXXX-
XXXXXXXXXXXXXXXXXXXXXXXXXXXXXXXX--XXXXX----------------------------XXXXXXXXXXXXXXXX--XXXXXXXXXXXXXXX-XXXXXXXXXXXXXXXXXXXXXXXXXXXXXXXXXXXXXXXXXXXXXXXX-