-----------------------------------------------------------------------------------------------------------------------%%%%%-------%%%%---------------
-----------------------------SSSSSSSSSSSSSSSSSSSSSSSSSSSSSSS------------K-----------------------------------------------------------------------------
-----------------------------------------------------------------------------------------------------C---------------------------------SS#CSS---------
------------------------------------------------------------------------------------------------------------------------------------------------------
----------------------------------------2--------------------------------------------------------------------SSSSS------------------------------------
------------------------------------------------------------------------------------------------------------------------------------------------------
------------------------------------------------------------------------------------------------------------------------------------------------------
----------------k----------------------------------------------------------------------------------------------------------------------------------F--
--------------?QQQ---%%%%%%---------------USS------%%%%-%%%--%%%%%---------------------------------------------------------------------------------#--
---------------------------------------------------------------------------------------------------------------------------------------------------#--
-------------------------###-----------------------------------------###-----------S--------SSSS-----------#-----------------------------SUSSS---#-#--
------------------------####------------E---------------#-----------##----------------TT-------------------##------------------------------------#-#--
----M-----------------TT###------------TT---tt----------#----------###---TT-----------TT----------*----#-#-#-------XX-------TT----------------TT-#-##-
--kkk---------------k-TT####----kkk----TT---tt----------#---------####---TT---gg-g-gggTT--kk------*----#-#-#-------XX-------TT---------k-gg---TT-#-##-
XXXXXXXXXXXXXXXXXXXXXXXXXXXXXXXXXXXXXXXXXXXXXXX--XXXXXXXXXXXXXXXXXXXXXXXXXXXXXXXXXXXXXXXXXXXXXXXXXXXXXXXXXXXXXXXXXXXXXXXXXXXXXXXXXXXXXXXXXXXXXXXXXXXXX
XXXXXXXXXXXXXXXXXXXXXXXXXXXXXXXXXXXXXXXXXXXXXXX--XXXXXXXXXXXXXXXXXXXXXXXXXXXXXXXXXXXXXXXXXXXXXXXXXXXXXXXXXXXXXXXXXXXXXXXXXXXXXXXXXXXXXXXXXXXXXXXXXXXXX