-------------------------------------------------------------------------------------------------------------------#----------------------------------
-----------------------------------------------------------------------------------------------------------y------##----------------------------------
-------------------------------------------------------------------------------------------------------QQ?SSSS---###----------------------------------
-----------------------%%%%-------------------------------------------------------------------------------------####-----SSSSSSSSSSSSSSSSS------------
---------------SSS!S------------------------------------------------------------------------------------------k#####-------------TT-------------------
--------------------------------------------------------------------------------------------------------------######-------------TT-------------SSSSSS
-------------------------------------------------------------------------------------------------------------#######-------------TT-------------------
------------------------------------------------------------------------------K-----------------------------########-------------TT-------------------
------------------------------------------------------------!---------------SSSSSS-------------------------#########----tt-------TT-----#-------------
--------------------------------------------------------------------------------------------------------gg###########---tt-gggg--TT-----#----k-----F--
-----------2----------------------!--------------SSSS---------------------------XXXXXXXXXXXXXXXXXXXXXXXXXXXXXXXXXXXXXXXXXXXXXXXXXXXXXXXXXXXXXXXXXXXXXX
---------TT------------------------------TT-------------TT---------------------XXXXXXXXXXXXXXXXXXXXXXXXXXXXXXXXXXXXXXXXXXXXXXXXXXXXXXXXXXXXXXXXXXXXXXX
---------TT---------------#--------------TT-------------TT-------TT-----------XXXXXXXXXXXXXXXXXXXXXXXXXXXXXXXXXXXXXXXXXXXXXXXXXXXXXXXXXXXXXXXXXXXXXXXX
----M----TT---------------#-------k--gg--TT---#---------TT-------TT----------XXXXXXXXXXXXXXXXXXXXXXXXXXXXXXXXXXXXXXXXXXXXXXXXXXXXXXXXXXXXXXXXXXXXXXXXX
XXXXXXXXXXXXXXXXXXXXXXXXXXXXXXXXXXXXXXXXXXXXXXXXXXXXXXXXXXXXXXXXXXXXXXXXXXXXXXXXXXXXXXXXXXXXXXXXXXXXXXXXXXXXXXXXXXXXXXXXXXXXXXXXXXXXXXXXXXXXXXXXXXXXXX
XXXXXXXXXXXXXXXXXXXXXXXXXXXXXXXXXXXXXXXXXXXXXXXXXXXXXXXXXXXXXXXXXXXXXXXXXXXXXXXXXXXXXXXXXXXXXXXXXXXXXXXXXXXXXXXXXXXXXXXXXXXXXXXXXXXXXXXXXXXXXXXXXXXXXX