-----------------S--------------------------------------------------------------------------%---------------------------------------------------------
-----------------S-----------------S------------------------------------------------------------------------------------------------------------------
-----------------SSSSSS-------------------------------------------------------------------------------------------------------------------------------
----------S------SSSSSS-----------------------------!-------------------------US------------------------------------------------%%%%%-----------------
----------S-------------------------------------------------------------------------------------------------------------------------------------------
----------S-------------------------------------------------------------------------------------------------------------------------------------------
-------------------------------------------------------------------------------------------------------------------------------T----------------------
------------------------QQQQQ--------------------------------------------------------------------------------------------------T----------------------
-----------2---------------------------------g---------------------------------------------------------------------------------T----------------------
------------------T------1----------%%%%%%%%%%---------------------------------------1-----------------------------------------T----------------------
------------------T--------------------------------#--------------------------------------------------------------------------#T--------------K--S----
------------------T--------------------------------#----------------------------------------k---------------------------------#T-------*---------S----
-------B----------T----------------------------T---#----------Q----------------USUSSSSSSSSSSSS------#------------------------##T-------*--------------
-#---y-b----------T-gg-------------yy-T--------T---#-gggg---------------------------T---TTTT-------##---gg-------------------##T-------*-------gg--F--
XXXXMXXXXXXXXXXXXXXXXXXXXXXXXXXXXXXXXXXXXXXXXXXXXXXXXXXXXXXXXXXXXXXXXXXXXXXXXXXXXXXXXXXXXXXXXXXXXXXXXXXXXXXXXXXXXXXXXXXXX----XXXXXXXXXXXXXXXXXXXXXXXXX
XXXXXXXXXXXXXXXXXXXXXXXXXXXXXXXXXXXXXXXXXXXXXXXXXXXXXXXXXXXXXXXXXXXXXXXXXXXXXXXXXXXXXXXXXXXXXXXXXXXXXXXXXXXXXXXXXXXXXXXXX----XXXXXXXXXXXXXXXXXXXXXXXXX