----------%%%%--------------------------------------------------------------------------S-------------------------------------------------------------
------------------------------------------------------------------------------------------------------------------------------------------------------
---------------------------------------SSSS------------------------------------------------------------------------------------------------------SSS--
------------------------------------------------------------------------------------------------------------------------------------------------------
------------------------US----------------------------------------------------------------------------------------------------------------------------
------------------------------------------------------------------------------------------------------------------------------------------------------
------%%%-----------------------------------------------------------------------------------2------------------------------------------------#--------
----------------------E--------------------------------------------------------------------------------------------------------------------#-#-#------
-------------2-------TT--------------------------------------------------------------------------------------------------------------------#-#-#------
-----------TT--------TT--------------------------------------------------R-----------------------------------------------------------------#-#-#------
-----------TT--------TT--------------------SSSS------------------------------------------------------------------------------------------###----------
-----------TT--------TT-----------------------------TT-----------------------------------------------------------SSSSS-------------------###----------
-----------TT--------TT-----------------------------TT----TT---------B-------------TT----------------------------------------------------###----------
----M------TT--gg-g--TT---#-------------#----------kTT----TT--g------b------gg-----TT-----#--------------------g-------------------------###---y--F---
XXXXXXXXXXXXXXXXXXXXXXX-XXXXXXXX---XXXXXXXXXXXXXXXXXXXXXXXXXXXXXXXXXXXXXXXXXXXXXXXXXXXXXXXXXXXXXXXXXXXXXXXXXXXXXXXXXXXXXXXXXXXXXXXXXXXXX-XXXXXXXXXX--%
XXXXXXXXXXXXXXXXXXXXXXX-XXXXXXXX---XXXXXXXXXXXXXXXXXXXXXXXXXXXXXXXXXXXXXXXXXXXXXXXXXXXXXXXXXXXXXXXXXXXXXXXXXXXXXXXXXXXXXXXXXXXXXXXXXXXXX-XXXXXXXXXX---