-----SSSSSS-----------------------------SSSSSSSS------------------------SSSSS#------------------------------------------------------------------------
-----SU---------------------------------SSSSSSUS---------------------------%%%------------------------------------------------------------------------
-------------------------------------------------USSSSSS-----------------------------------SS------------------------------------------------SSSS-----
-------------------------------------------------------------------------------------------------------------------------------------2----------------
----------------------------------------------------------------K-----------------------------------------------------------------------------%%%%%%%%
-------------------------------------------------#----------------------------------------------------------------------------------------------------
-------------------------------------------------#---------------------------------------------------T--------g--------------------C------------------
------------------------------------------------##---------------------------------------------------T-----SLSSSSU------------------------------------
-----------------------------------------------###---------------------------------------------------T------------------------------------------------
----------------------------------------------####---------------------------------------------------T-----------------t------------------------------
---SSSSSSS------------%%%%-------------------#####------------------------------------------TTT------T-----------------t--------------R---------------
--------------------------------SSSSS!SSSS-#######-----T------------------------------------TTT------T-----------------t------------------------------
---------------SSSSSSSS--k--------##-T--k#########----kT---------k----kk----------------k#--TTT----ggT-----------------t---------#--------------------
---ggg---------XXXXXXXXXXXXXXXXXXXXXXXXXXXXXXXXXXXXXXXXXXXXXXXXXXXXXXXXXXXXXXXXXXXXXXXXXXXXXXXXXXXXXXXXXXXXXXXXXXXXXXXXXXXXX-----#-------k--K------F--
XXXXMXXX-------XXXXXXXXXXXXXXXXXXXXXXXXXXXXXXXXXXXXXXXXXXXXXXXXXXXXXXXXXXXXXXXXXXXXXXXXXXXXXXXXXXXXXXXXXXXXXXXXXXXXXXXXXXXXXXXXXXXXXXXXXXXXXXXXX--XXXX
XXXXXXXX----XX-XXXXXXXXXXXXXXXXXXXXXXXXXXXXXXXXXXXXXXXXXXXXXXXXXXXXXXXXXXXXXXXXXXXXXXXXXXXXXXXXXXXXXXXXXXXXXXXXXXXXXXXXXXXXXXXXXXXXXXXXXXXXXXXXX--XXXX