---------------------------------------------------------------------------------------------SSS------------------------------------------------------
-SSSS--------------------------------------------------------------------------g-------------------------------------------------------------------SS-
-------------------------------------------------------------------------------SSS-----------------------------------------------------------------SS-
------------------------------------------------------------------------------------------------------------------------------------------------------
------------------------------------------------------------------------------------------------------------------------------------------------------
------------------------------------------------------------------------------------------------SS----------------------------------------------------
------------------------------------------------------------------------------------------------------------------------------------------------------
----g---SSS---------------------------SSSSU-----------------------------------------------------------------------------------------------------%%%%%%
--%%%%-----------------------------------%%------------------------------------------------------------SSSSSSSS--------------------#----------B-------
----------------------#--------SSS--------------------------------CS---------------------------------------------------------------#-y--------b-gggF-S
---------------------##------#---------------------------------B------T---------------------2-------------Q--------------#---------XXXXXXXXXXXXXXXXX--
---------------------##-----##---------------------------------b-----kT--g-----------------T----------#------------------#---------XXXXXXXXXXXXXXXXX--
-------------------#-##-----##-------------------------------XXXXXXXXXXXXX-TTTTTT--SSSS----T---#------#------------------#---------XXXXXXXXXXXXXXXXX--
----------------k--####--kk-##---B-------------gg------------XXXXXXXXXXXXX-TTTTTT--SSSS----T---#-----##----------------%-#---------XXXXXXXXXXXXXXXXX--
XXXXMXXXXXXXXXXXXXXXXXXXXXXXXXXXXXXXXXXXXXXXXXXXXXXXXXXX-----XXXXXXXXXXXXX-TTTTTT----------T---#-ggg-##-------------kk---#--gggg---XXXXXXXXXXXXXXXXX--
XXXXXXXXXXXXXXXXXXXXXXXXXXXXXXXXXXXXXXXXXXXXXXXXXXXXXXXX-----XXXXXXXXXXXXX-XXXXXXXXXXXXXXXXXXXXXXXXXXXX-----XXXXXXXXXXXXXXXXXXXX---XXXXXXXXXXXXXXXXX--