------------------------------------------------------------------------------------------------------------------------------------------------------
------------------------------------------------SSS----------SS---SSS---------------------------------------------------------------------------------
---------------------------------------------------------------#--SUS---------------------------------------------------------------------------------
--------------------------------------------------------------##----------%%%------TTT----------------------------------------------------------------
---------------------------------------CSS-------------------###-------------%%%%%-TTT----------------------------------------------------------------
---------------------------------------------#--------------####-------------------TTT------------------------------------------SSSSSSSSSSSSSSSUSS----
---------------%-----------------------------#-------------#####-------------------TTT-TT-----------K--------------------------------------#----------
-----------------------#-----###-------------#-------------#####-------------------TTT-TT---------------------------------------%%%%%%-T---#----------
-----------------------#--y--###-------------#-------------#####-#-----------------TTT-TT----------------------------------------tt----T---#----------
---------------------###-###-###------------##---SSSSS-----#######--K---%----------TTT-TT-----------------------SSSS-------------tt----T---#-----F----
---------------------#######-#-#-----------###-------T-----#######------------kk---TTT-TT-----------------g---------gg-----------tt----T---#-k---g----
--T----------------#########-#-#-----------XXXXXXXXXXXXXXXXXXXXXXXXXXXXXXXXXXXXXXXXXXXXXXXXXXXXXXXXXXXXXXXXXXXXXXXXXXXXXXXXXXXXXXXXXXXXXXXXXXXXXXX----
--T----------k---r-#############------k----XXXXXXXXXXXXXXXXXXXXXXXXXXXXXXXXXXXXXXXXXXXXXXXXXXXXXXXXXXXXXXXXXXXXXXXXXXXXXXXXXXXXXXXXXXXXXXXXXXXXXXX----
--T-------XXXXXXXXXXXXXXXXXXXXXXXXXXXXXXXX-XXXXXXXXXXXXXXXXXXXXXXXXXXXXXXXXXXXXXXXXXXXXXXXXXXXXXXXXXXXXXXXXXXXXXXXXXXXXXXXXXXXXXXXXXXXXXXXXXXXXXXX----
XXX----MT-XXXXXXXXXXXXXXXXXXXXXXXXXXXXXXXX-XXXXXXXXXXXXXXXXXXXXXXXXXXXXXXXXXXXXXXXXXXXXXXXXXXXXXXXXXXXXXXXXXXXXXXXXXXXXXXXXXXXXXXXXXXXXXXXXXXXXXXX----
XXX----XX-XXXXXXXXXXXXXXXXXXXXXXXXXXXXXXXX-XXXXXXXXXXXXXXXXXXXXXXXXXXXXXXXXXXXXXXXXXXXXXXXXXXXXXXXXXXXXXXXXXXXXXXXXXXXXXXXXXXXXXXXXXXXXXXXXXXXXXXX----