------------------------------------------%%%%%-------------------------------------------------------------------------------------------------------
-----------------CS------------------------------------------------------------------------------------------------------------------U---------------%
------------------------------------------------------------------------------------------------------------------------------------------------------
------------------------------------------------------------------------------------------------------------------------------------------------------
-----------------------------------------------------------------------------------------2----------------------------------------------------------T-
-------------------------------------------------------------------1--------------------------------------------------------------------------------T-
--------------------------------------------------------------------SSS?Q-2-------------------------------------------------------------------------T-
-----------#----------------------------S--------------------------------2-----------SSSSSSSSSS--TT----------------------TTT-----------------------FT-
-------------------------------------------------------------------------------------------------TT----------------------TTT--------------XXXXXXXXXXXX
----------------#--------------------------------------------------------------------------------TT-----------k----------TTT--------------XXXXXXXXXXXX
----------------#----------------------r---------------------------------------------------------XXXXXXXXXXXXXXXXXXXXXXXXXXXXXXXXXXXXXXXXXXXXXXXXXXXXX
---------------##-------------------%%%%%%%%-----------------------------------------------TTTT--XXXXXXXXXXXXXXXXXXXXXXXXXXXXXXXXXXXXXXXXXXXXXXXXXXXXX
---------------##---------gggg---T---------------gg#---k----------------gg--------ggg-----kTTTT--XXXXXXXXXXXXXXXXXXXXXXXXXXXXXXXXXXXXXXXXXXXXXXXXXXXXX
-------g-------##---XXXXXXXXXXXXXXXXXXXXXXXXXXXXXXXXXXXXXXXXXXXXXXXXXXXXXXXXXXXXXXXXXXXXXXXXXXX--XXXXXXXXXXXXXXXXXXXXXXXXXXXXXXXXXXXXXXXXXXXXXXXXXXXXX
XXXXMXXXXXXXXXXXX---XXXXXXXXXXXXXXXXXXXXXXXXXXXXXXXXXXXXXXXXXXXXXXXXXXXXXXXXXXXXXXXXXXXXXXXXXXX--XXXXXXXXXXXXXXXXXXXXXXXXXXXXXXXXXXXXXXXXXXXXXXXXXXXXX
XXXXXXXXXXXXXXXXX---XXXXXXXXXXXXXXXXXXXXXXXXXXXXXXXXXXXXXXXXXXXXXXXXXXXXXXXXXXXXXXXXXXXXXXXXXXX--XXXXXXXXXXXXXXXXXXXXXXXXXXXXXXXXXXXXXXXXXXXXXXXXXXXXX