---------------------------------------------------------------------------------------------------------------------------------------XX-------------
-------------------------------SS---------------------------------------------------------------------------------------------------------------------
-----------------------------------------------------------------------------------------------------#--------------------S--------------SSSS---------
----------------------------------------------------------------------------------------------------##------------------------------------------------
--------------------------------------Q------------------------------------------------------------###------------------------------------------------
--------------------------------------------------------------------------------------------------####------------------------------------------------
-------------------------------------------------------------------------------------g#----------#####-------Q----------QQ----------------------------
------------------------------------------------------------------------------------g##---------######------------------------------------------------
----------------------------------------------SSSSSS--------------------------------###--------#######--------#------------USS------------------------
----------------------------------------------SSSSSS-------------------------------####-------########--------#---------------------------------------
----------------------------------------------------------------------------------#####------#########--------#--------------y------------------------
-----------------------------------tt-----#----------------#-------------------y-######-----##########-------##--------------XSSSSSSSSSSSSSSS----#-F--
-------TT--------------------tt----tt-----#---------------##----------------y-#########----###########---g#####----tt-------XXXXXXXXXXXXXXXXXXXXXXXXXX
----M--TT--------------------tt---ktt-----#------y-------###---------y-----############---############---######----tt------XXXXXXXXXXXXXXXXXXXXXXXXXXX
XXXXXXXXXXXXXXXXXXXXXXXXXXXXXXXXXXXXXXXXXXXXXXXXXXXXXXXXXXXXXXXXXXXXXXXXXXXXXXXXXXXXXXXXXXXXXXXXXXXXXXXXXXXXXXXXXXXXXXXXXXXXXXXXXXXXXXXXXXXXXXXXXXXXXX
XXXXXXXXXXXXXXXXXXXXXXXXXXXXXXXXXXXXXXXXXXXXXXXXXXXXXXXXXXXXXXXXXXXXXXXXXXXXXXXXXXXXXXXXXXXXXXXXXXXXXXXXXXXXXXXXXXXXXXXXXXXXXXXXXXXXXXXXXXXXXXXXXXXXXX