------------------------------------------------------------------------------------------------------------------------------------------------------
------------------------------------------------------------------------------------------------------------------------------------------------------
------------------------------------------------------------------------------------------------------------------------------------------------------
S-----SSSSSSSSSSSSSSSSSSSSSSSSSSSSSSSSSSSSSSSSSSSSSSSSSSSSSSSSSSSSSSSSSSSSSSSSSSSSSSSSSSSLSSSSSSSSSSSSSSSSSSSSSSSSSSSSSSSSSSSSSSSSSSSSSSSSSSSSSSSSS---
S-----------------------------------------------------SS--SSSSSS--SSSS------SSSS----------------------------------------------------------------------
S-----------------------------------------------------SS--SSSSSS--SSSS---g--SSSS----------------------------------------------------------------------
S---------------------------------------------------SS--------SS---S----SS----------------------------------------------------------------------------
S---------------------------------------------------SS--------SS---S----SS----------------------------------------------------------------------------
S--------------------------------------S-SSSS-U-----SS--------SS---S----SS----------SSSSSS------------------------------------------------------------
S----------------------------C---------S-S--S-S-----SS--------SS---S-U--SC--g-g-----SSSSSS------------------------------------------------------------
S---------@QQQQ--------#-#-------------SSS--SSS-----SSSS--SSSSSS---SSS--SS--SSSS-----------------------------TT---------------------------------------
S--------------------#-#-#-#---#----------------------SS-----------------------------------------------TT----TT-----------SS-------------------K------
S----------------g-#-#-#-#-#---#-#--------------------SS-----------------------------------------------TT----TT----TT-----SS--------------B-----------
S---------------g#-#-#-#-#-#-E-#-#--------kk----------------k--g-g------------------------------g-g-g--TT----TT--g-TT-----SS--------------b-------F---
XXXXXXXXXXXXXXXXXXXXXXXXXXXXXXXXXXXXXXXXXXXXXXXXXXXXXXXXXXXXXXXXXXXXXXXXXXXXXXXX---XXXXXXXXXXXXXXXXXXXXXXXXXXXXXXXXXXXXX--XX--XXXXXXXXXXXXXXXXXXXXX---
XXXXXXXXXXXXXXXXXXXXXXXXXXXXXXXXXXXXXXXXXXXXXXXXXXXXXXXXXXXXXXXXXXXXXXXXXXXXXXXX---XXXXXXXXXXXXXXXXXXXXXXXXXXXXXXXXXXXXX--XX--XXXXXXXXXXXXXXXXXXXXX---